/exist/apps/fragtrag/thespis/testimonia/Thespis_TESTIMONIA.xml#Thespis-test-1	urn:cite2:fragtrag:thespis.testimonia.test:1
/exist/apps/fragtrag/thespis/testimonia/Thespis_TESTIMONIA.xml#Thespis-test-2	urn:cite2:fragtrag:thespis.testimonia.test:2
/exist/apps/fragtrag/thespis/testimonia/Thespis_TESTIMONIA.xml#Thespis-test-3	urn:cite2:fragtrag:thespis.testimonia.test:3
/exist/apps/fragtrag/thespis/testimonia/Thespis_TESTIMONIA.xml#Thespis-test-4	urn:cite2:fragtrag:thespis.testimonia.test:4
/exist/apps/fragtrag/thespis/testimonia/Thespis_TESTIMONIA.xml#Thespis-test-5	urn:cite2:fragtrag:thespis.testimonia.test:5
/exist/apps/fragtrag/thespis/testimonia/Thespis_TESTIMONIA.xml#Thespis-test-6	urn:cite2:fragtrag:thespis.testimonia.test:6
/exist/apps/fragtrag/thespis/testimonia/Thespis_TESTIMONIA.xml#Thespis-test-7	urn:cite2:fragtrag:thespis.testimonia.test:7
/exist/apps/fragtrag/thespis/testimonia/Thespis_TESTIMONIA.xml#Thespis-test-8	urn:cite2:fragtrag:thespis.testimonia.test:8
/exist/apps/fragtrag/thespis/testimonia/Thespis_TESTIMONIA.xml#Thespis-test-9	urn:cite2:fragtrag:thespis.testimonia.test:9
/exist/apps/fragtrag/thespis/testimonia/Thespis_TESTIMONIA.xml#Thespis-test-10	urn:cite2:fragtrag:thespis.testimonia.test:10
/exist/apps/fragtrag/thespis/testimonia/Thespis_TESTIMONIA.xml#Thespis-test-11	urn:cite2:fragtrag:thespis.testimonia.test:11
/exist/apps/fragtrag/thespis/testimonia/Thespis_TESTIMONIA.xml#Thespis-test-12	urn:cite2:fragtrag:thespis.testimonia.test:12
/exist/apps/fragtrag/thespis/testimonia/Thespis_TESTIMONIA.xml#Thespis-test-13	urn:cite2:fragtrag:thespis.testimonia.test:13
/exist/apps/fragtrag/thespis/testimonia/Thespis_TESTIMONIA.xml#Thespis-test-14	urn:cite2:fragtrag:thespis.testimonia.test:14
/exist/apps/fragtrag/thespis/testimonia/Thespis_TESTIMONIA.xml#Thespis-test-15	urn:cite2:fragtrag:thespis.testimonia.test:15
/exist/apps/fragtrag/thespis/fragmenta/Thespis_FRAGMENTA.xml#Thespis-Athla_Peliou_or_Phorbas-title	urn:cite2:fragtrag:thespis.fragmenta.title:Athla_Peliou_or_Phorbas
/exist/apps/fragtrag/thespis/fragmenta/Thespis_FRAGMENTA.xml#Thespis-Hiereis-title	urn:cite2:fragtrag:thespis.fragmenta.title:Hiereis
/exist/apps/fragtrag/thespis/fragmenta/Thespis_FRAGMENTA.xml#Thespis-Eitheoi-title	urn:cite2:fragtrag:thespis.fragmenta.title:Eitheoi
/exist/apps/fragtrag/thespis/fragmenta/Thespis_FRAGMENTA.xml#Thespis-Pentheus-title	urn:cite2:fragtrag:thespis.fragmenta.title:Pentheus
/exist/apps/fragtrag/thespis/fragmenta/Thespis_FRAGMENTA.xml#Thespis-frag-1	urn:cite2:fragtrag:thespis.fragmenta.frag:1
/exist/apps/fragtrag/thespis/fragmenta/Thespis_FRAGMENTA.xml#Thespis-UP-title	urn:cite2:fragtrag:thespis.fragmenta.title:UP
/exist/apps/fragtrag/thespis/fragmenta/Thespis_FRAGMENTA.xml#Thespis-frag-2	urn:cite2:fragtrag:thespis.fragmenta.frag:2
/exist/apps/fragtrag/thespis/fragmenta/Thespis_FRAGMENTA.xml#Thespis-frag-3	urn:cite2:fragtrag:thespis.fragmenta.frag:3
/exist/apps/fragtrag/thespis/fragmenta/Thespis_FRAGMENTA.xml#Thespis-frag-4	urn:cite2:fragtrag:thespis.fragmenta.frag:4
/exist/apps/fragtrag/thespis/fragmenta/Thespis_FRAGMENTA.xml#Thespis-frag-5	urn:cite2:fragtrag:thespis.fragmenta.frag:5
/exist/apps/fragtrag/choerilus/testimonia/Choerilus_TESTIMONIA.xml#Choerilus-test-1	urn:cite2:fragtrag:choerilus.testimonia.test:1
/exist/apps/fragtrag/choerilus/testimonia/Choerilus_TESTIMONIA.xml#Choerilus-test-2	urn:cite2:fragtrag:choerilus.testimonia.test:2
/exist/apps/fragtrag/choerilus/testimonia/Choerilus_TESTIMONIA.xml#Choerilus-test-3	urn:cite2:fragtrag:choerilus.testimonia.test:3
/exist/apps/fragtrag/choerilus/testimonia/Choerilus_TESTIMONIA.xml#Choerilus-test-4	urn:cite2:fragtrag:choerilus.testimonia.test:4
/exist/apps/fragtrag/choerilus/testimonia/Choerilus_TESTIMONIA.xml#Choerilus-test-5	urn:cite2:fragtrag:choerilus.testimonia.test:5
/exist/apps/fragtrag/choerilus/fragmenta/Choerilus_FRAGMENTA.xml#Choerilus-Alope-title	urn:cite2:fragtrag:choerilus.fragmenta.title:Alope
/exist/apps/fragtrag/choerilus/fragmenta/Choerilus_FRAGMENTA.xml#Choerilus-rep-1	urn:cite2:fragtrag:choerilus.fragmenta.rep:1
/exist/apps/fragtrag/choerilus/fragmenta/Choerilus_FRAGMENTA.xml#Choerilus-UP-title	urn:cite2:fragtrag:choerilus.fragmenta.title:UP
/exist/apps/fragtrag/choerilus/fragmenta/Choerilus_FRAGMENTA.xml#Choerilus-frag-1	urn:cite2:fragtrag:choerilus.fragmenta.frag:1
/exist/apps/fragtrag/choerilus/fragmenta/Choerilus_FRAGMENTA.xml#Choerilus-frag-2	urn:cite2:fragtrag:choerilus.fragmenta.frag:2
/exist/apps/fragtrag/phrynichus/testimonia/Phrynichus_TESTIMONIA.xml#Phrynichus-test-1	urn:cite2:fragtrag:phrynichus.testimonia.test:1
/exist/apps/fragtrag/phrynichus/testimonia/Phrynichus_TESTIMONIA.xml#Phrynichus-test-2	urn:cite2:fragtrag:phrynichus.testimonia.test:2
/exist/apps/fragtrag/phrynichus/testimonia/Phrynichus_TESTIMONIA.xml#Phrynichus-test-3	urn:cite2:fragtrag:phrynichus.testimonia.test:3
/exist/apps/fragtrag/phrynichus/testimonia/Phrynichus_TESTIMONIA.xml#Phrynichus-test-4	urn:cite2:fragtrag:phrynichus.testimonia.test:4
/exist/apps/fragtrag/phrynichus/testimonia/Phrynichus_TESTIMONIA.xml#Phrynichus-test-5	urn:cite2:fragtrag:phrynichus.testimonia.test:5
/exist/apps/fragtrag/phrynichus/testimonia/Phrynichus_TESTIMONIA.xml#Phrynichus-test-6	urn:cite2:fragtrag:phrynichus.testimonia.test:6
/exist/apps/fragtrag/phrynichus/testimonia/Phrynichus_TESTIMONIA.xml#Phrynichus-test-7	urn:cite2:fragtrag:phrynichus.testimonia.test:7
/exist/apps/fragtrag/phrynichus/testimonia/Phrynichus_TESTIMONIA.xml#Phrynichus-test-8	urn:cite2:fragtrag:phrynichus.testimonia.test:8
/exist/apps/fragtrag/phrynichus/testimonia/Phrynichus_TESTIMONIA.xml#Phrynichus-test-9	urn:cite2:fragtrag:phrynichus.testimonia.test:9
/exist/apps/fragtrag/phrynichus/testimonia/Phrynichus_TESTIMONIA.xml#Phrynichus-test-10	urn:cite2:fragtrag:phrynichus.testimonia.test:10
/exist/apps/fragtrag/phrynichus/testimonia/Phrynichus_TESTIMONIA.xml#Phrynichus-test-11	urn:cite2:fragtrag:phrynichus.testimonia.test:11
/exist/apps/fragtrag/phrynichus/testimonia/Phrynichus_TESTIMONIA.xml#Phrynichus-test-12	urn:cite2:fragtrag:phrynichus.testimonia.test:12
/exist/apps/fragtrag/phrynichus/testimonia/Phrynichus_TESTIMONIA.xml#Phrynichus-test-13	urn:cite2:fragtrag:phrynichus.testimonia.test:13
/exist/apps/fragtrag/phrynichus/testimonia/Phrynichus_TESTIMONIA.xml#Phrynichus-test-14	urn:cite2:fragtrag:phrynichus.testimonia.test:14
/exist/apps/fragtrag/phrynichus/testimonia/Phrynichus_TESTIMONIA.xml#Phrynichus-test-15	urn:cite2:fragtrag:phrynichus.testimonia.test:15
/exist/apps/fragtrag/phrynichus/testimonia/Phrynichus_TESTIMONIA.xml#Phrynichus-test-16	urn:cite2:fragtrag:phrynichus.testimonia.test:16
/exist/apps/fragtrag/phrynichus/testimonia/Phrynichus_TESTIMONIA.xml#Phrynichus-test-17	urn:cite2:fragtrag:phrynichus.testimonia.test:17
/exist/apps/fragtrag/phrynichus/testimonia/Phrynichus_TESTIMONIA.xml#Phrynichus-test-18	urn:cite2:fragtrag:phrynichus.testimonia.test:18
/exist/apps/fragtrag/phrynichus/testimonia/Phrynichus_TESTIMONIA.xml#Phrynichus-test-19	urn:cite2:fragtrag:phrynichus.testimonia.test:19
/exist/apps/fragtrag/phrynichus/testimonia/Phrynichus_TESTIMONIA.xml#Phrynichus-test-20	urn:cite2:fragtrag:phrynichus.testimonia.test:20
/exist/apps/fragtrag/phrynichus/testimonia/Phrynichus_TESTIMONIA.xml#Phrynichus-test-21	urn:cite2:fragtrag:phrynichus.testimonia.test:21
/exist/apps/fragtrag/phrynichus/testimonia/Phrynichus_TESTIMONIA.xml#Phrynichus-test-22	urn:cite2:fragtrag:phrynichus.testimonia.test:22
/exist/apps/fragtrag/phrynichus/testimonia/Phrynichus_TESTIMONIA.xml#Phrynichus-test-23	urn:cite2:fragtrag:phrynichus.testimonia.test:23
/exist/apps/fragtrag/phrynichus/testimonia/Phrynichus_TESTIMONIA.xml#Phrynichus-test-24	urn:cite2:fragtrag:phrynichus.testimonia.test:24
/exist/apps/fragtrag/phrynichus/testimonia/Phrynichus_TESTIMONIA.xml#Phrynichus-test-25	urn:cite2:fragtrag:phrynichus.testimonia.test:25
/exist/apps/fragtrag/phrynichus/testimonia/Phrynichus_TESTIMONIA.xml#Phrynichus-test-26	urn:cite2:fragtrag:phrynichus.testimonia.test:26
/exist/apps/fragtrag/phrynichus/fragmenta/Phrynichus_FRAGMENTA.xml#Phrynichus-Aigyptioi-title	urn:cite2:fragtrag:phrynichus.fragmenta.title:Aigyptioi
/exist/apps/fragtrag/phrynichus/fragmenta/Phrynichus_FRAGMENTA.xml#Phrynichus-rep-1	urn:cite2:fragtrag:phrynichus.fragmenta.rep:1
/exist/apps/fragtrag/phrynichus/fragmenta/Phrynichus_FRAGMENTA.xml#Phrynichus-frag-1	urn:cite2:fragtrag:phrynichus.fragmenta.frag:1
/exist/apps/fragtrag/phrynichus/fragmenta/Phrynichus_FRAGMENTA.xml#Phrynichus-Aktaion-title	urn:cite2:fragtrag:phrynichus.fragmenta.title:Aktaion
/exist/apps/fragtrag/phrynichus/fragmenta/Phrynichus_FRAGMENTA.xml#Phrynichus-Alkestis-title	urn:cite2:fragtrag:phrynichus.fragmenta.title:Alkestis
/exist/apps/fragtrag/phrynichus/fragmenta/Phrynichus_FRAGMENTA.xml#Phrynichus-rep-2	urn:cite2:fragtrag:phrynichus.fragmenta.rep:2
/exist/apps/fragtrag/phrynichus/fragmenta/Phrynichus_FRAGMENTA.xml#Phrynichus-frag-2	urn:cite2:fragtrag:phrynichus.fragmenta.frag:2
/exist/apps/fragtrag/phrynichus/fragmenta/Phrynichus_FRAGMENTA.xml#Phrynichus-Antaios-title	urn:cite2:fragtrag:phrynichus.fragmenta.title:Antaios
/exist/apps/fragtrag/phrynichus/fragmenta/Phrynichus_FRAGMENTA.xml#Phrynichus-rep-3a	urn:cite2:fragtrag:phrynichus.fragmenta.rep:3a
/exist/apps/fragtrag/phrynichus/fragmenta/Phrynichus_FRAGMENTA.xml#Phrynichus-rep-3b	urn:cite2:fragtrag:phrynichus.fragmenta.rep:3b
/exist/apps/fragtrag/phrynichus/fragmenta/Phrynichus_FRAGMENTA.xml#Phrynichus-Danaides-title	urn:cite2:fragtrag:phrynichus.fragmenta.title:Danaides
/exist/apps/fragtrag/phrynichus/fragmenta/Phrynichus_FRAGMENTA.xml#Phrynichus-frag-3	urn:cite2:fragtrag:phrynichus.fragmenta.frag:3
/exist/apps/fragtrag/phrynichus/fragmenta/Phrynichus_FRAGMENTA.xml#Phrynichus-Dikaioi-title	urn:cite2:fragtrag:phrynichus.fragmenta.title:Dikaioi
/exist/apps/fragtrag/phrynichus/fragmenta/Phrynichus_FRAGMENTA.xml#Phrynichus-Miletou-title	urn:cite2:fragtrag:phrynichus.fragmenta.title:Miletou
/exist/apps/fragtrag/phrynichus/fragmenta/Phrynichus_FRAGMENTA.xml#Phrynichus-Pleuroniai-title	urn:cite2:fragtrag:phrynichus.fragmenta.title:Pleuroniai
/exist/apps/fragtrag/phrynichus/fragmenta/Phrynichus_FRAGMENTA.xml#Phrynichus-frag-4	urn:cite2:fragtrag:phrynichus.fragmenta.frag:4
/exist/apps/fragtrag/phrynichus/fragmenta/Phrynichus_FRAGMENTA.xml#Phrynichus-frag-5	urn:cite2:fragtrag:phrynichus.fragmenta.frag:5
/exist/apps/fragtrag/phrynichus/fragmenta/Phrynichus_FRAGMENTA.xml#Phrynichus-Tantalos-title	urn:cite2:fragtrag:phrynichus.fragmenta.title:Tantalos
/exist/apps/fragtrag/phrynichus/fragmenta/Phrynichus_FRAGMENTA.xml#Phrynichus-frag-6	urn:cite2:fragtrag:phrynichus.fragmenta.frag:6
/exist/apps/fragtrag/phrynichus/fragmenta/Phrynichus_FRAGMENTA.xml#Phrynichus-Phoinissai-title	urn:cite2:fragtrag:phrynichus.fragmenta.title:Phoinissai
/exist/apps/fragtrag/phrynichus/fragmenta/Phrynichus_FRAGMENTA.xml#Phrynichus-frag-7	urn:cite2:fragtrag:phrynichus.fragmenta.frag:7
/exist/apps/fragtrag/phrynichus/fragmenta/Phrynichus_FRAGMENTA.xml#Phrynichus-frag-8	urn:cite2:fragtrag:phrynichus.fragmenta.frag:8
/exist/apps/fragtrag/phrynichus/fragmenta/Phrynichus_FRAGMENTA.xml#Phrynichus-frag-9	urn:cite2:fragtrag:phrynichus.fragmenta.frag:9
/exist/apps/fragtrag/phrynichus/fragmenta/Phrynichus_FRAGMENTA.xml#Phrynichus-frag-10	urn:cite2:fragtrag:phrynichus.fragmenta.frag:10
/exist/apps/fragtrag/phrynichus/fragmenta/Phrynichus_FRAGMENTA.xml#Phrynichus-frag-11	urn:cite2:fragtrag:phrynichus.fragmenta.frag:11
/exist/apps/fragtrag/phrynichus/fragmenta/Phrynichus_FRAGMENTA.xml#Phrynichus-frag-12	urn:cite2:fragtrag:phrynichus.fragmenta.frag:12
/exist/apps/fragtrag/phrynichus/fragmenta/Phrynichus_FRAGMENTA.xml#Phrynichus-UP-title	urn:cite2:fragtrag:phrynichus.fragmenta.title:UP
/exist/apps/fragtrag/phrynichus/fragmenta/Phrynichus_FRAGMENTA.xml#Phrynichus-frag-13	urn:cite2:fragtrag:phrynichus.fragmenta.frag:13
/exist/apps/fragtrag/phrynichus/fragmenta/Phrynichus_FRAGMENTA.xml#Phrynichus-frag-14	urn:cite2:fragtrag:phrynichus.fragmenta.frag:14
/exist/apps/fragtrag/phrynichus/fragmenta/Phrynichus_FRAGMENTA.xml#Phrynichus-frag-15	urn:cite2:fragtrag:phrynichus.fragmenta.frag:15
/exist/apps/fragtrag/phrynichus/fragmenta/Phrynichus_FRAGMENTA.xml#Phrynichus-frag-16	urn:cite2:fragtrag:phrynichus.fragmenta.frag:16
/exist/apps/fragtrag/phrynichus/fragmenta/Phrynichus_FRAGMENTA.xml#Phrynichus-frag-17	urn:cite2:fragtrag:phrynichus.fragmenta.frag:17
/exist/apps/fragtrag/phrynichus/fragmenta/Phrynichus_FRAGMENTA.xml#Phrynichus-frag-18	urn:cite2:fragtrag:phrynichus.fragmenta.frag:18
/exist/apps/fragtrag/phrynichus/fragmenta/Phrynichus_FRAGMENTA.xml#Phrynichus-frag-19	urn:cite2:fragtrag:phrynichus.fragmenta.frag:19
/exist/apps/fragtrag/phrynichus/fragmenta/Phrynichus_FRAGMENTA.xml#Phrynichus-frag-20	urn:cite2:fragtrag:phrynichus.fragmenta.frag:20
/exist/apps/fragtrag/phrynichus/fragmenta/Phrynichus_FRAGMENTA.xml#Phrynichus-frag-21	urn:cite2:fragtrag:phrynichus.fragmenta.frag:21
/exist/apps/fragtrag/phrynichus/fragmenta/Phrynichus_FRAGMENTA.xml#Phrynichus-frag-22	urn:cite2:fragtrag:phrynichus.fragmenta.frag:22
/exist/apps/fragtrag/pratinas/testimonia/Pratinas_TESTIMONIA.xml#Pratinas-test-1	urn:cite2:fragtrag:pratinas.testimonia.test:1
/exist/apps/fragtrag/pratinas/testimonia/Pratinas_TESTIMONIA.xml#Pratinas-test-2	urn:cite2:fragtrag:pratinas.testimonia.test:2
/exist/apps/fragtrag/pratinas/testimonia/Pratinas_TESTIMONIA.xml#Pratinas-test-3	urn:cite2:fragtrag:pratinas.testimonia.test:3
/exist/apps/fragtrag/pratinas/testimonia/Pratinas_TESTIMONIA.xml#Pratinas-test-4	urn:cite2:fragtrag:pratinas.testimonia.test:4
/exist/apps/fragtrag/pratinas/testimonia/Pratinas_TESTIMONIA.xml#Pratinas-test-5	urn:cite2:fragtrag:pratinas.testimonia.test:5
/exist/apps/fragtrag/pratinas/testimonia/Pratinas_TESTIMONIA.xml#Pratinas-test-6	urn:cite2:fragtrag:pratinas.testimonia.test:6
/exist/apps/fragtrag/pratinas/testimonia/Pratinas_TESTIMONIA.xml#Pratinas-test-7	urn:cite2:fragtrag:pratinas.testimonia.test:7
/exist/apps/fragtrag/pratinas/testimonia/Pratinas_TESTIMONIA.xml#Pratinas-test-8	urn:cite2:fragtrag:pratinas.testimonia.test:8
/exist/apps/fragtrag/pratinas/testimonia/Pratinas_TESTIMONIA.xml#Pratinas-test-9	urn:cite2:fragtrag:pratinas.testimonia.test:9
/exist/apps/fragtrag/pratinas/testimonia/Pratinas_TESTIMONIA.xml#Pratinas-test-10	urn:cite2:fragtrag:pratinas.testimonia.test:10
/exist/apps/fragtrag/pratinas/fragmenta/Pratinas_FRAGMENTA.xml#Pratinas-Dymainai-title	urn:cite2:fragtrag:pratinas.fragmenta.title:Dymainai
/exist/apps/fragtrag/pratinas/fragmenta/Pratinas_FRAGMENTA.xml#Pratinas-frag-1	urn:cite2:fragtrag:pratinas.fragmenta.frag:1
/exist/apps/fragtrag/pratinas/fragmenta/Pratinas_FRAGMENTA.xml#Pratinas-Perseus-title	urn:cite2:fragtrag:pratinas.fragmenta.title:Perseus
/exist/apps/fragtrag/pratinas/fragmenta/Pratinas_FRAGMENTA.xml#Pratinas-Tantalos-title	urn:cite2:fragtrag:pratinas.fragmenta.title:Tantalos
/exist/apps/fragtrag/pratinas/fragmenta/Pratinas_FRAGMENTA.xml#Pratinas-Palaistai-title	urn:cite2:fragtrag:pratinas.fragmenta.title:Palaistai
/exist/apps/fragtrag/pratinas/fragmenta/Pratinas_FRAGMENTA.xml#Pratinas-UP-title	urn:cite2:fragtrag:pratinas.fragmenta.title:UP
/exist/apps/fragtrag/pratinas/fragmenta/Pratinas_FRAGMENTA.xml#Pratinas-frag-2	urn:cite2:fragtrag:pratinas.fragmenta.frag:2
/exist/apps/fragtrag/pratinas/fragmenta/Pratinas_FRAGMENTA.xml#Pratinas-frag-3	urn:cite2:fragtrag:pratinas.fragmenta.frag:3
/exist/apps/fragtrag/pratinas/fragmenta/Pratinas_FRAGMENTA.xml#Pratinas-frag-4	urn:cite2:fragtrag:pratinas.fragmenta.frag:4
/exist/apps/fragtrag/pratinas/fragmenta/Pratinas_FRAGMENTA.xml#Pratinas-frag-5	urn:cite2:fragtrag:pratinas.fragmenta.frag:5
/exist/apps/fragtrag/euetes/testimonia/Euetes_TESTIMONIA.xml#Euetes-test-1	urn:cite2:fragtrag:euetes.testimonia.test:1
/exist/apps/fragtrag/euetes/testimonia/Euetes_TESTIMONIA.xml#Euetes-test-2	urn:cite2:fragtrag:euetes.testimonia.test:2
/exist/apps/fragtrag/polyphrasmon/testimonia/Polyphrasmon_TESTIMONIA.xml#Polyphrasmon-test-1	urn:cite2:fragtrag:polyphrasmon.testimonia.test:1
/exist/apps/fragtrag/polyphrasmon/testimonia/Polyphrasmon_TESTIMONIA.xml#Polyphrasmon-test-2	urn:cite2:fragtrag:polyphrasmon.testimonia.test:2
/exist/apps/fragtrag/polyphrasmon/testimonia/Polyphrasmon_TESTIMONIA.xml#Polyphrasmon-test-3	urn:cite2:fragtrag:polyphrasmon.testimonia.test:3
/exist/apps/fragtrag/polyphrasmon/testimonia/Polyphrasmon_TESTIMONIA.xml#Polyphrasmon-test-4	urn:cite2:fragtrag:polyphrasmon.testimonia.test:4
/exist/apps/fragtrag/polyphrasmon/testimonia/Polyphrasmon_TESTIMONIA.xml#Polyphrasmon-test-5	urn:cite2:fragtrag:polyphrasmon.testimonia.test:5
/exist/apps/fragtrag/polyphrasmon/fragmenta/Polyphrasmon_FRAGMENTA.xml#Polyphrasmon-Lykourgeia-title	urn:cite2:fragtrag:polyphrasmon.fragmenta.title:Lykourgeia
/exist/apps/fragtrag/aristias/testimonia/Aristias_TESTIMONIA.xml#Aristias-test-1	urn:cite2:fragtrag:aristias.testimonia.test:1
/exist/apps/fragtrag/aristias/testimonia/Aristias_TESTIMONIA.xml#Aristias-test-2	urn:cite2:fragtrag:aristias.testimonia.test:2
/exist/apps/fragtrag/aristias/testimonia/Aristias_TESTIMONIA.xml#Aristias-test-3	urn:cite2:fragtrag:aristias.testimonia.test:3
/exist/apps/fragtrag/aristias/testimonia/Aristias_TESTIMONIA.xml#Aristias-test-4	urn:cite2:fragtrag:aristias.testimonia.test:4
/exist/apps/fragtrag/aristias/testimonia/Aristias_TESTIMONIA.xml#Aristias-test-5	urn:cite2:fragtrag:aristias.testimonia.test:5
/exist/apps/fragtrag/aristias/fragmenta/Aristias_FRAGMENTA.xml#Aristias-Antaios-title	urn:cite2:fragtrag:aristias.fragmenta.title:Antaios
/exist/apps/fragtrag/aristias/fragmenta/Aristias_FRAGMENTA.xml#Aristias-frag-1	urn:cite2:fragtrag:aristias.fragmenta.frag:1
/exist/apps/fragtrag/aristias/fragmenta/Aristias_FRAGMENTA.xml#Aristias-Atalante-title	urn:cite2:fragtrag:aristias.fragmenta.title:Atalante
/exist/apps/fragtrag/aristias/fragmenta/Aristias_FRAGMENTA.xml#Aristias-frag-2	urn:cite2:fragtrag:aristias.fragmenta.frag:2
/exist/apps/fragtrag/aristias/fragmenta/Aristias_FRAGMENTA.xml#Aristias-Keres-title	urn:cite2:fragtrag:aristias.fragmenta.title:Keres
/exist/apps/fragtrag/aristias/fragmenta/Aristias_FRAGMENTA.xml#Aristias-frag-3	urn:cite2:fragtrag:aristias.fragmenta.frag:3
/exist/apps/fragtrag/aristias/fragmenta/Aristias_FRAGMENTA.xml#Aristias-Kyklops-title	urn:cite2:fragtrag:aristias.fragmenta.title:Kyklops
/exist/apps/fragtrag/aristias/fragmenta/Aristias_FRAGMENTA.xml#Aristias-frag-4	urn:cite2:fragtrag:aristias.fragmenta.frag:4
/exist/apps/fragtrag/aristias/fragmenta/Aristias_FRAGMENTA.xml#Aristias-Orpheus-title	urn:cite2:fragtrag:aristias.fragmenta.title:Orpheus
/exist/apps/fragtrag/aristias/fragmenta/Aristias_FRAGMENTA.xml#Aristias-frag-5	urn:cite2:fragtrag:aristias.fragmenta.frag:5
/exist/apps/fragtrag/aristias/fragmenta/Aristias_FRAGMENTA.xml#Aristias-UP-title	urn:cite2:fragtrag:aristias.fragmenta.title:UP
/exist/apps/fragtrag/aristias/fragmenta/Aristias_FRAGMENTA.xml#Aristias-frag-6	urn:cite2:fragtrag:aristias.fragmenta.frag:6
/exist/apps/fragtrag/aristias/fragmenta/Aristias_FRAGMENTA.xml#Aristias-frag-7	urn:cite2:fragtrag:aristias.fragmenta.frag:7
/exist/apps/fragtrag/mesatus/testimonia/Mesatus_TESTIMONIA.xml#Mesatus-test-1	urn:cite2:fragtrag:mesatus.testimonia.test:1
/exist/apps/fragtrag/mesatus/testimonia/Mesatus_TESTIMONIA.xml#Mesatus-test-2	urn:cite2:fragtrag:mesatus.testimonia.test:2
/exist/apps/fragtrag/mesatus/testimonia/Mesatus_TESTIMONIA.xml#Mesatus-test-3	urn:cite2:fragtrag:mesatus.testimonia.test:3
/exist/apps/fragtrag/mesatus/testimonia/Mesatus_TESTIMONIA.xml#Mesatus-test-4	urn:cite2:fragtrag:mesatus.testimonia.test:4
/exist/apps/fragtrag/mesatus/fragmenta/Mesatus_FRAGMENTA.xml#Mesatus-N--title	urn:cite2:fragtrag:mesatus.fragmenta.title:
/exist/apps/fragtrag/mesatus/fragmenta/Mesatus_FRAGMENTA.xml#Mesatus-Bacchae-title	urn:cite2:fragtrag:mesatus.fragmenta.title:Bacchae
/exist/apps/fragtrag/mesatus/fragmenta/Mesatus_FRAGMENTA.xml#Mesatus-Kophoi-title	urn:cite2:fragtrag:mesatus.fragmenta.title:Kophoi
/exist/apps/fragtrag/mesatus/fragmenta/Mesatus_FRAGMENTA.xml#Mesatus-Poimenes-title	urn:cite2:fragtrag:mesatus.fragmenta.title:Poimenes
/exist/apps/fragtrag/mesatus/fragmenta/Mesatus_FRAGMENTA.xml#Mesatus-Kyk--title	urn:cite2:fragtrag:mesatus.fragmenta.title:
/exist/apps/fragtrag/euphorion/testimonia/Euphorion_TESTIMONIA.xml#Euphorion-test-1	urn:cite2:fragtrag:euphorion.testimonia.test:1
/exist/apps/fragtrag/euphorion/testimonia/Euphorion_TESTIMONIA.xml#Euphorion-test-2	urn:cite2:fragtrag:euphorion.testimonia.test:2
/exist/apps/fragtrag/euphorion/testimonia/Euphorion_TESTIMONIA.xml#Euphorion-test-3	urn:cite2:fragtrag:euphorion.testimonia.test:3
/exist/apps/fragtrag/euaeon/testimonia/Euaeon_TESTIMONIA.xml#Euaeon-test-1	urn:cite2:fragtrag:euaeon.testimonia.test:1
/exist/apps/fragtrag/euaeon/testimonia/Euaeon_TESTIMONIA.xml#Euaeon-test-2a	urn:cite2:fragtrag:euaeon.testimonia.test:2a
/exist/apps/fragtrag/euaeon/testimonia/Euaeon_TESTIMONIA.xml#Euaeon-test-2b	urn:cite2:fragtrag:euaeon.testimonia.test:2b
/exist/apps/fragtrag/euaeon/testimonia/Euaeon_TESTIMONIA.xml#Euaeon-test-2c	urn:cite2:fragtrag:euaeon.testimonia.test:2c
/exist/apps/fragtrag/aristarchustegeates/testimonia/Aristarchustegeates_TESTIMONIA.xml#Aristarchustegeates-test-1	urn:cite2:fragtrag:aristarchustegeates.testimonia.test:1
/exist/apps/fragtrag/aristarchustegeates/testimonia/Aristarchustegeates_TESTIMONIA.xml#Aristarchustegeates-test-2	urn:cite2:fragtrag:aristarchustegeates.testimonia.test:2
/exist/apps/fragtrag/aristarchustegeates/testimonia/Aristarchustegeates_TESTIMONIA.xml#Aristarchustegeates-test-3	urn:cite2:fragtrag:aristarchustegeates.testimonia.test:3
/exist/apps/fragtrag/aristarchustegeates/testimonia/Aristarchustegeates_TESTIMONIA.xml#Aristarchustegeates-test-4	urn:cite2:fragtrag:aristarchustegeates.testimonia.test:4
/exist/apps/fragtrag/aristarchustegeates/fragmenta/Aristarchustegeates_FRAGMENTA.xml#Aristarchustegeates-Asklepios-title	urn:cite2:fragtrag:aristarchustegeates.fragmenta.title:Asklepios
/exist/apps/fragtrag/aristarchustegeates/fragmenta/Aristarchustegeates_FRAGMENTA.xml#Aristarchustegeates-Achilleus-title	urn:cite2:fragtrag:aristarchustegeates.fragmenta.title:Achilleus
/exist/apps/fragtrag/aristarchustegeates/fragmenta/Aristarchustegeates_FRAGMENTA.xml#Aristarchustegeates-rep-1	urn:cite2:fragtrag:aristarchustegeates.fragmenta.rep:1
/exist/apps/fragtrag/aristarchustegeates/fragmenta/Aristarchustegeates_FRAGMENTA.xml#Aristarchustegeates-rep-2	urn:cite2:fragtrag:aristarchustegeates.fragmenta.rep:2
/exist/apps/fragtrag/aristarchustegeates/fragmenta/Aristarchustegeates_FRAGMENTA.xml#Aristarchustegeates-rep-3(?)	urn:cite2:fragtrag:aristarchustegeates.fragmenta.rep:3(?)
/exist/apps/fragtrag/aristarchustegeates/fragmenta/Aristarchustegeates_FRAGMENTA.xml#Aristarchustegeates-Tantalos-title	urn:cite2:fragtrag:aristarchustegeates.fragmenta.title:Tantalos
/exist/apps/fragtrag/aristarchustegeates/fragmenta/Aristarchustegeates_FRAGMENTA.xml#Aristarchustegeates-frag-1	urn:cite2:fragtrag:aristarchustegeates.fragmenta.frag:1
/exist/apps/fragtrag/aristarchustegeates/fragmenta/Aristarchustegeates_FRAGMENTA.xml#Aristarchustegeates-UP-title	urn:cite2:fragtrag:aristarchustegeates.fragmenta.title:UP
/exist/apps/fragtrag/aristarchustegeates/fragmenta/Aristarchustegeates_FRAGMENTA.xml#Aristarchustegeates-frag-2	urn:cite2:fragtrag:aristarchustegeates.fragmenta.frag:2
/exist/apps/fragtrag/aristarchustegeates/fragmenta/Aristarchustegeates_FRAGMENTA.xml#Aristarchustegeates-frag-3	urn:cite2:fragtrag:aristarchustegeates.fragmenta.frag:3
/exist/apps/fragtrag/aristarchustegeates/fragmenta/Aristarchustegeates_FRAGMENTA.xml#Aristarchustegeates-frag-4	urn:cite2:fragtrag:aristarchustegeates.fragmenta.frag:4
/exist/apps/fragtrag/aristarchustegeates/fragmenta/Aristarchustegeates_FRAGMENTA.xml#Aristarchustegeates-rep-4	urn:cite2:fragtrag:aristarchustegeates.fragmenta.rep:4
/exist/apps/fragtrag/neophron/testimonia/Neophron_TESTIMONIA.xml#Neophron-test-1	urn:cite2:fragtrag:neophron.testimonia.test:1
/exist/apps/fragtrag/neophron/testimonia/Neophron_TESTIMONIA.xml#Neophron-test-2	urn:cite2:fragtrag:neophron.testimonia.test:2
/exist/apps/fragtrag/neophron/testimonia/Neophron_TESTIMONIA.xml#Neophron-test-3	urn:cite2:fragtrag:neophron.testimonia.test:3
/exist/apps/fragtrag/neophron/fragmenta/Neophron_FRAGMENTA.xml#Neophron-Medeia-title	urn:cite2:fragtrag:neophron.fragmenta.title:Medeia
/exist/apps/fragtrag/neophron/fragmenta/Neophron_FRAGMENTA.xml#Neophron-frag-1	urn:cite2:fragtrag:neophron.fragmenta.frag:1
/exist/apps/fragtrag/neophron/fragmenta/Neophron_FRAGMENTA.xml#Neophron-frag-2	urn:cite2:fragtrag:neophron.fragmenta.frag:2
/exist/apps/fragtrag/neophron/fragmenta/Neophron_FRAGMENTA.xml#Neophron-frag-3	urn:cite2:fragtrag:neophron.fragmenta.frag:3
/exist/apps/fragtrag/euripidesi/testimonia/Euripidesi_TESTIMONIA.xml#Euripidesi-test-1	urn:cite2:fragtrag:euripidesi.testimonia.test:1
/exist/apps/fragtrag/euripidesii/testimonia/Euripidesii_TESTIMONIA.xml#Euripidesii-test-1	urn:cite2:fragtrag:euripidesii.testimonia.test:1
/exist/apps/fragtrag/euripidesii/fragmenta/Euripidesii_FRAGMENTA.xml#Euripidesii-Orestes-title	urn:cite2:fragtrag:euripidesii.fragmenta.title:Orestes
/exist/apps/fragtrag/euripidesii/fragmenta/Euripidesii_FRAGMENTA.xml#Euripidesii-Medeia-title	urn:cite2:fragtrag:euripidesii.fragmenta.title:Medeia
/exist/apps/fragtrag/euripidesii/fragmenta/Euripidesii_FRAGMENTA.xml#Euripidesii-Polyxene-title	urn:cite2:fragtrag:euripidesii.fragmenta.title:Polyxene
/exist/apps/fragtrag/ion/testimonia/Ion_TESTIMONIA.xml#Ion-test-1	urn:cite2:fragtrag:ion.testimonia.test:1
/exist/apps/fragtrag/ion/testimonia/Ion_TESTIMONIA.xml#Ion-test-2	urn:cite2:fragtrag:ion.testimonia.test:2
/exist/apps/fragtrag/ion/testimonia/Ion_TESTIMONIA.xml#Ion-test-3	urn:cite2:fragtrag:ion.testimonia.test:3
/exist/apps/fragtrag/ion/testimonia/Ion_TESTIMONIA.xml#Ion-test-4	urn:cite2:fragtrag:ion.testimonia.test:4
/exist/apps/fragtrag/ion/testimonia/Ion_TESTIMONIA.xml#Ion-test-5	urn:cite2:fragtrag:ion.testimonia.test:5
/exist/apps/fragtrag/ion/testimonia/Ion_TESTIMONIA.xml#Ion-test-6	urn:cite2:fragtrag:ion.testimonia.test:6
/exist/apps/fragtrag/ion/testimonia/Ion_TESTIMONIA.xml#Ion-test-7	urn:cite2:fragtrag:ion.testimonia.test:7
/exist/apps/fragtrag/ion/testimonia/Ion_TESTIMONIA.xml#Ion-test-8	urn:cite2:fragtrag:ion.testimonia.test:8
/exist/apps/fragtrag/ion/testimonia/Ion_TESTIMONIA.xml#Ion-test-9	urn:cite2:fragtrag:ion.testimonia.test:9
/exist/apps/fragtrag/ion/testimonia/Ion_TESTIMONIA.xml#Ion-test-10	urn:cite2:fragtrag:ion.testimonia.test:10
/exist/apps/fragtrag/ion/testimonia/Ion_TESTIMONIA.xml#Ion-test-11	urn:cite2:fragtrag:ion.testimonia.test:11
/exist/apps/fragtrag/ion/testimonia/Ion_TESTIMONIA.xml#Ion-test-12	urn:cite2:fragtrag:ion.testimonia.test:12
/exist/apps/fragtrag/ion/testimonia/Ion_TESTIMONIA.xml#Ion-test-13	urn:cite2:fragtrag:ion.testimonia.test:13
/exist/apps/fragtrag/ion/testimonia/Ion_TESTIMONIA.xml#Ion-test-14	urn:cite2:fragtrag:ion.testimonia.test:14
/exist/apps/fragtrag/ion/testimonia/Ion_TESTIMONIA.xml#Ion-test-15	urn:cite2:fragtrag:ion.testimonia.test:15
/exist/apps/fragtrag/ion/testimonia/Ion_TESTIMONIA.xml#Ion-test-16	urn:cite2:fragtrag:ion.testimonia.test:16
/exist/apps/fragtrag/ion/fragmenta/Ion_FRAGMENTA.xml#Ion-Agamemnon-title	urn:cite2:fragtrag:ion.fragmenta.title:Agamemnon
/exist/apps/fragtrag/ion/fragmenta/Ion_FRAGMENTA.xml#Ion-frag-1	urn:cite2:fragtrag:ion.fragmenta.frag:1
/exist/apps/fragtrag/ion/fragmenta/Ion_FRAGMENTA.xml#Ion-frag-2	urn:cite2:fragtrag:ion.fragmenta.frag:2
/exist/apps/fragtrag/ion/fragmenta/Ion_FRAGMENTA.xml#Ion-frag-3	urn:cite2:fragtrag:ion.fragmenta.frag:3
/exist/apps/fragtrag/ion/fragmenta/Ion_FRAGMENTA.xml#Ion-frag-4	urn:cite2:fragtrag:ion.fragmenta.frag:4
/exist/apps/fragtrag/ion/fragmenta/Ion_FRAGMENTA.xml#Ion-frag-5	urn:cite2:fragtrag:ion.fragmenta.frag:5
/exist/apps/fragtrag/ion/fragmenta/Ion_FRAGMENTA.xml#Ion-Alkmene-title	urn:cite2:fragtrag:ion.fragmenta.title:Alkmene
/exist/apps/fragtrag/ion/fragmenta/Ion_FRAGMENTA.xml#Ion-frag-6	urn:cite2:fragtrag:ion.fragmenta.frag:6
/exist/apps/fragtrag/ion/fragmenta/Ion_FRAGMENTA.xml#Ion-frag-7	urn:cite2:fragtrag:ion.fragmenta.frag:7
/exist/apps/fragtrag/ion/fragmenta/Ion_FRAGMENTA.xml#Ion-frag-8	urn:cite2:fragtrag:ion.fragmenta.frag:8
/exist/apps/fragtrag/ion/fragmenta/Ion_FRAGMENTA.xml#Ion-frag-9	urn:cite2:fragtrag:ion.fragmenta.frag:9
/exist/apps/fragtrag/ion/fragmenta/Ion_FRAGMENTA.xml#Ion-Argeioi-title	urn:cite2:fragtrag:ion.fragmenta.title:Argeioi
/exist/apps/fragtrag/ion/fragmenta/Ion_FRAGMENTA.xml#Ion-frag-10	urn:cite2:fragtrag:ion.fragmenta.frag:10
/exist/apps/fragtrag/ion/fragmenta/Ion_FRAGMENTA.xml#Ion-frag-11	urn:cite2:fragtrag:ion.fragmenta.frag:11
/exist/apps/fragtrag/ion/fragmenta/Ion_FRAGMENTA.xml#Ion-frag-12	urn:cite2:fragtrag:ion.fragmenta.frag:12
/exist/apps/fragtrag/ion/fragmenta/Ion_FRAGMENTA.xml#Ion-Eurytidai-title	urn:cite2:fragtrag:ion.fragmenta.title:Eurytidai
/exist/apps/fragtrag/ion/fragmenta/Ion_FRAGMENTA.xml#Ion-frag-13	urn:cite2:fragtrag:ion.fragmenta.frag:13
/exist/apps/fragtrag/ion/fragmenta/Ion_FRAGMENTA.xml#Ion-frag-14	urn:cite2:fragtrag:ion.fragmenta.frag:14
/exist/apps/fragtrag/ion/fragmenta/Ion_FRAGMENTA.xml#Ion-frag-15	urn:cite2:fragtrag:ion.fragmenta.frag:15
/exist/apps/fragtrag/ion/fragmenta/Ion_FRAGMENTA.xml#Ion-frag-16	urn:cite2:fragtrag:ion.fragmenta.frag:16
/exist/apps/fragtrag/ion/fragmenta/Ion_FRAGMENTA.xml#Ion-frag-17	urn:cite2:fragtrag:ion.fragmenta.frag:17
/exist/apps/fragtrag/ion/fragmenta/Ion_FRAGMENTA.xml#Ion-Laertes-title	urn:cite2:fragtrag:ion.fragmenta.title:Laertes
/exist/apps/fragtrag/ion/fragmenta/Ion_FRAGMENTA.xml#Ion-frag-18	urn:cite2:fragtrag:ion.fragmenta.frag:18
/exist/apps/fragtrag/ion/fragmenta/Ion_FRAGMENTA.xml#Ion-Megadrama-title	urn:cite2:fragtrag:ion.fragmenta.title:Megadrama
/exist/apps/fragtrag/ion/fragmenta/Ion_FRAGMENTA.xml#Ion-frag-19	urn:cite2:fragtrag:ion.fragmenta.frag:19
/exist/apps/fragtrag/ion/fragmenta/Ion_FRAGMENTA.xml#Ion-frag-20	urn:cite2:fragtrag:ion.fragmenta.frag:20
/exist/apps/fragtrag/ion/fragmenta/Ion_FRAGMENTA.xml#Ion-frag-21	urn:cite2:fragtrag:ion.fragmenta.frag:21
/exist/apps/fragtrag/ion/fragmenta/Ion_FRAGMENTA.xml#Ion-Omphale-title	urn:cite2:fragtrag:ion.fragmenta.title:Omphale
/exist/apps/fragtrag/ion/fragmenta/Ion_FRAGMENTA.xml#Ion-rep-1	urn:cite2:fragtrag:ion.fragmenta.rep:1
/exist/apps/fragtrag/ion/fragmenta/Ion_FRAGMENTA.xml#Ion-frag-22	urn:cite2:fragtrag:ion.fragmenta.frag:22
/exist/apps/fragtrag/ion/fragmenta/Ion_FRAGMENTA.xml#Ion-frag-23	urn:cite2:fragtrag:ion.fragmenta.frag:23
/exist/apps/fragtrag/ion/fragmenta/Ion_FRAGMENTA.xml#Ion-frag-24	urn:cite2:fragtrag:ion.fragmenta.frag:24
/exist/apps/fragtrag/ion/fragmenta/Ion_FRAGMENTA.xml#Ion-frag-25	urn:cite2:fragtrag:ion.fragmenta.frag:25
/exist/apps/fragtrag/ion/fragmenta/Ion_FRAGMENTA.xml#Ion-frag-26	urn:cite2:fragtrag:ion.fragmenta.frag:26
/exist/apps/fragtrag/ion/fragmenta/Ion_FRAGMENTA.xml#Ion-frag-27	urn:cite2:fragtrag:ion.fragmenta.frag:27
/exist/apps/fragtrag/ion/fragmenta/Ion_FRAGMENTA.xml#Ion-frag-28	urn:cite2:fragtrag:ion.fragmenta.frag:28
/exist/apps/fragtrag/ion/fragmenta/Ion_FRAGMENTA.xml#Ion-frag-29	urn:cite2:fragtrag:ion.fragmenta.frag:29
/exist/apps/fragtrag/ion/fragmenta/Ion_FRAGMENTA.xml#Ion-frag-30	urn:cite2:fragtrag:ion.fragmenta.frag:30
/exist/apps/fragtrag/ion/fragmenta/Ion_FRAGMENTA.xml#Ion-frag-31	urn:cite2:fragtrag:ion.fragmenta.frag:31
/exist/apps/fragtrag/ion/fragmenta/Ion_FRAGMENTA.xml#Ion-frag-32	urn:cite2:fragtrag:ion.fragmenta.frag:32
/exist/apps/fragtrag/ion/fragmenta/Ion_FRAGMENTA.xml#Ion-frag-33	urn:cite2:fragtrag:ion.fragmenta.frag:33
/exist/apps/fragtrag/ion/fragmenta/Ion_FRAGMENTA.xml#Ion-frag-34	urn:cite2:fragtrag:ion.fragmenta.frag:34
/exist/apps/fragtrag/ion/fragmenta/Ion_FRAGMENTA.xml#Ion-frag-35	urn:cite2:fragtrag:ion.fragmenta.frag:35
/exist/apps/fragtrag/ion/fragmenta/Ion_FRAGMENTA.xml#Ion-frag-36	urn:cite2:fragtrag:ion.fragmenta.frag:36
/exist/apps/fragtrag/ion/fragmenta/Ion_FRAGMENTA.xml#Ion-frag-37	urn:cite2:fragtrag:ion.fragmenta.frag:37
/exist/apps/fragtrag/ion/fragmenta/Ion_FRAGMENTA.xml#Ion-frag-38	urn:cite2:fragtrag:ion.fragmenta.frag:38
/exist/apps/fragtrag/ion/fragmenta/Ion_FRAGMENTA.xml#Ion-Teukros-title	urn:cite2:fragtrag:ion.fragmenta.title:Teukros
/exist/apps/fragtrag/ion/fragmenta/Ion_FRAGMENTA.xml#Ion-frag-39	urn:cite2:fragtrag:ion.fragmenta.frag:39
/exist/apps/fragtrag/ion/fragmenta/Ion_FRAGMENTA.xml#Ion-frag-40	urn:cite2:fragtrag:ion.fragmenta.frag:40
/exist/apps/fragtrag/ion/fragmenta/Ion_FRAGMENTA.xml#Ion-Phoinix-title	urn:cite2:fragtrag:ion.fragmenta.title:Phoinix
/exist/apps/fragtrag/ion/fragmenta/Ion_FRAGMENTA.xml#Ion-frag-41	urn:cite2:fragtrag:ion.fragmenta.frag:41
/exist/apps/fragtrag/ion/fragmenta/Ion_FRAGMENTA.xml#Ion-frag-42	urn:cite2:fragtrag:ion.fragmenta.frag:42
/exist/apps/fragtrag/ion/fragmenta/Ion_FRAGMENTA.xml#Ion-frag-43	urn:cite2:fragtrag:ion.fragmenta.frag:43
/exist/apps/fragtrag/ion/fragmenta/Ion_FRAGMENTA.xml#Ion-frag-44	urn:cite2:fragtrag:ion.fragmenta.frag:44
/exist/apps/fragtrag/ion/fragmenta/Ion_FRAGMENTA.xml#Ion-frag-45	urn:cite2:fragtrag:ion.fragmenta.frag:45
/exist/apps/fragtrag/ion/fragmenta/Ion_FRAGMENTA.xml#Ion-frag-46	urn:cite2:fragtrag:ion.fragmenta.frag:46
/exist/apps/fragtrag/ion/fragmenta/Ion_FRAGMENTA.xml#Ion-frag-47	urn:cite2:fragtrag:ion.fragmenta.frag:47
/exist/apps/fragtrag/ion/fragmenta/Ion_FRAGMENTA.xml#Ion-frag-48	urn:cite2:fragtrag:ion.fragmenta.frag:48
/exist/apps/fragtrag/ion/fragmenta/Ion_FRAGMENTA.xml#Ion-Phoinixii-title	urn:cite2:fragtrag:ion.fragmenta.title:Phoinixii
/exist/apps/fragtrag/ion/fragmenta/Ion_FRAGMENTA.xml#Ion-frag-49	urn:cite2:fragtrag:ion.fragmenta.frag:49
/exist/apps/fragtrag/ion/fragmenta/Ion_FRAGMENTA.xml#Ion-frag-50	urn:cite2:fragtrag:ion.fragmenta.frag:50
/exist/apps/fragtrag/ion/fragmenta/Ion_FRAGMENTA.xml#Ion-Phrouroi-title	urn:cite2:fragtrag:ion.fragmenta.title:Phrouroi
/exist/apps/fragtrag/ion/fragmenta/Ion_FRAGMENTA.xml#Ion-frag-51	urn:cite2:fragtrag:ion.fragmenta.frag:51
/exist/apps/fragtrag/ion/fragmenta/Ion_FRAGMENTA.xml#Ion-frag-52	urn:cite2:fragtrag:ion.fragmenta.frag:52
/exist/apps/fragtrag/ion/fragmenta/Ion_FRAGMENTA.xml#Ion-frag-53	urn:cite2:fragtrag:ion.fragmenta.frag:53
/exist/apps/fragtrag/ion/fragmenta/Ion_FRAGMENTA.xml#Ion-frag-54	urn:cite2:fragtrag:ion.fragmenta.frag:54
/exist/apps/fragtrag/ion/fragmenta/Ion_FRAGMENTA.xml#Ion-frag-55	urn:cite2:fragtrag:ion.fragmenta.frag:55
/exist/apps/fragtrag/ion/fragmenta/Ion_FRAGMENTA.xml#Ion-frag-56	urn:cite2:fragtrag:ion.fragmenta.frag:56
/exist/apps/fragtrag/ion/fragmenta/Ion_FRAGMENTA.xml#Ion-frag-57	urn:cite2:fragtrag:ion.fragmenta.frag:57
/exist/apps/fragtrag/ion/fragmenta/Ion_FRAGMENTA.xml#Ion-frag-58	urn:cite2:fragtrag:ion.fragmenta.frag:58
/exist/apps/fragtrag/ion/fragmenta/Ion_FRAGMENTA.xml#Ion-frag-59	urn:cite2:fragtrag:ion.fragmenta.frag:59
/exist/apps/fragtrag/ion/fragmenta/Ion_FRAGMENTA.xml#Ion-UP-title	urn:cite2:fragtrag:ion.fragmenta.title:UP
/exist/apps/fragtrag/ion/fragmenta/Ion_FRAGMENTA.xml#Ion-frag-60	urn:cite2:fragtrag:ion.fragmenta.frag:60
/exist/apps/fragtrag/ion/fragmenta/Ion_FRAGMENTA.xml#Ion-frag-61	urn:cite2:fragtrag:ion.fragmenta.frag:61
/exist/apps/fragtrag/ion/fragmenta/Ion_FRAGMENTA.xml#Ion-frag-62	urn:cite2:fragtrag:ion.fragmenta.frag:62
/exist/apps/fragtrag/ion/fragmenta/Ion_FRAGMENTA.xml#Ion-frag-63	urn:cite2:fragtrag:ion.fragmenta.frag:63
/exist/apps/fragtrag/ion/fragmenta/Ion_FRAGMENTA.xml#Ion-frag-64	urn:cite2:fragtrag:ion.fragmenta.frag:64
/exist/apps/fragtrag/ion/fragmenta/Ion_FRAGMENTA.xml#Ion-frag-65	urn:cite2:fragtrag:ion.fragmenta.frag:65
/exist/apps/fragtrag/ion/fragmenta/Ion_FRAGMENTA.xml#Ion-frag-66	urn:cite2:fragtrag:ion.fragmenta.frag:66
/exist/apps/fragtrag/ion/fragmenta/Ion_FRAGMENTA.xml#Ion-frag-67	urn:cite2:fragtrag:ion.fragmenta.frag:67
/exist/apps/fragtrag/ion/fragmenta/Ion_FRAGMENTA.xml#Ion-frag-68	urn:cite2:fragtrag:ion.fragmenta.frag:68
/exist/apps/fragtrag/ion/fragmenta/Ion_FRAGMENTA.xml#Ion-frag-69	urn:cite2:fragtrag:ion.fragmenta.frag:69
/exist/apps/fragtrag/ion/fragmenta/Ion_FRAGMENTA.xml#Ion-frag-70	urn:cite2:fragtrag:ion.fragmenta.frag:70
/exist/apps/fragtrag/ion/fragmenta/Ion_FRAGMENTA.xml#Ion-frag-71	urn:cite2:fragtrag:ion.fragmenta.frag:71
/exist/apps/fragtrag/ion/fragmenta/Ion_FRAGMENTA.xml#Ion-frag-72	urn:cite2:fragtrag:ion.fragmenta.frag:72
/exist/apps/fragtrag/ion/fragmenta/Ion_FRAGMENTA.xml#Ion-frag-73	urn:cite2:fragtrag:ion.fragmenta.frag:73
/exist/apps/fragtrag/ion/fragmenta/Ion_FRAGMENTA.xml#Ion-frag-74	urn:cite2:fragtrag:ion.fragmenta.frag:74
/exist/apps/fragtrag/ion/fragmenta/Ion_FRAGMENTA.xml#Ion-frag-75	urn:cite2:fragtrag:ion.fragmenta.frag:75
/exist/apps/fragtrag/ion/fragmenta/Ion_FRAGMENTA.xml#Ion-frag-76	urn:cite2:fragtrag:ion.fragmenta.frag:76
/exist/apps/fragtrag/ion/fragmenta/Ion_FRAGMENTA.xml#Ion-frag-77	urn:cite2:fragtrag:ion.fragmenta.frag:77
/exist/apps/fragtrag/ion/fragmenta/Ion_FRAGMENTA.xml#Ion-frag-78	urn:cite2:fragtrag:ion.fragmenta.frag:78
/exist/apps/fragtrag/ion/fragmenta/Ion_FRAGMENTA.xml#Ion-frag-79	urn:cite2:fragtrag:ion.fragmenta.frag:79
/exist/apps/fragtrag/ion/fragmenta/Ion_FRAGMENTA.xml#Ion-frag-80	urn:cite2:fragtrag:ion.fragmenta.frag:80
/exist/apps/fragtrag/ion/fragmenta/Ion_FRAGMENTA.xml#Ion-frag-81	urn:cite2:fragtrag:ion.fragmenta.frag:81
/exist/apps/fragtrag/ion/fragmenta/Ion_FRAGMENTA.xml#Ion-frag-82	urn:cite2:fragtrag:ion.fragmenta.frag:82
/exist/apps/fragtrag/ion/fragmenta/Ion_FRAGMENTA.xml#Ion-frag-83	urn:cite2:fragtrag:ion.fragmenta.frag:83
/exist/apps/fragtrag/ion/fragmenta/Ion_FRAGMENTA.xml#Ion-frag-84	urn:cite2:fragtrag:ion.fragmenta.frag:84
/exist/apps/fragtrag/ion/fragmenta/Ion_FRAGMENTA.xml#Ion-frag-85	urn:cite2:fragtrag:ion.fragmenta.frag:85
/exist/apps/fragtrag/ion/fragmenta/Ion_FRAGMENTA.xml#Ion-frag-86	urn:cite2:fragtrag:ion.fragmenta.frag:86
/exist/apps/fragtrag/ion/fragmenta/Ion_FRAGMENTA.xml#Ion-rep-2	urn:cite2:fragtrag:ion.fragmenta.rep:2
/exist/apps/fragtrag/achaeusi/testimonia/Achaeusi_TESTIMONIA.xml#Achaeusi-test-1	urn:cite2:fragtrag:achaeusi.testimonia.test:1
/exist/apps/fragtrag/achaeusi/testimonia/Achaeusi_TESTIMONIA.xml#Achaeusi-test-2	urn:cite2:fragtrag:achaeusi.testimonia.test:2
/exist/apps/fragtrag/achaeusi/testimonia/Achaeusi_TESTIMONIA.xml#Achaeusi-test-3	urn:cite2:fragtrag:achaeusi.testimonia.test:3
/exist/apps/fragtrag/achaeusi/testimonia/Achaeusi_TESTIMONIA.xml#Achaeusi-test-4	urn:cite2:fragtrag:achaeusi.testimonia.test:4
/exist/apps/fragtrag/achaeusi/testimonia/Achaeusi_TESTIMONIA.xml#Achaeusi-test-5	urn:cite2:fragtrag:achaeusi.testimonia.test:5
/exist/apps/fragtrag/achaeusi/testimonia/Achaeusi_TESTIMONIA.xml#Achaeusi-test-6	urn:cite2:fragtrag:achaeusi.testimonia.test:6
/exist/apps/fragtrag/achaeusi/testimonia/Achaeusi_TESTIMONIA.xml#Achaeusi-test-7	urn:cite2:fragtrag:achaeusi.testimonia.test:7
/exist/apps/fragtrag/achaeusi/testimonia/Achaeusi_TESTIMONIA.xml#Achaeusi-test-8	urn:cite2:fragtrag:achaeusi.testimonia.test:8
/exist/apps/fragtrag/achaeusi/testimonia/Achaeusi_TESTIMONIA.xml#Achaeusi-test-9	urn:cite2:fragtrag:achaeusi.testimonia.test:9
/exist/apps/fragtrag/achaeusi/fragmenta/Achaeusi_FRAGMENTA.xml#Achaeusi-Adrastos-title	urn:cite2:fragtrag:achaeusi.fragmenta.title:Adrastos
/exist/apps/fragtrag/achaeusi/fragmenta/Achaeusi_FRAGMENTA.xml#Achaeusi-frag-1	urn:cite2:fragtrag:achaeusi.fragmenta.frag:1
/exist/apps/fragtrag/achaeusi/fragmenta/Achaeusi_FRAGMENTA.xml#Achaeusi-Azanes-title	urn:cite2:fragtrag:achaeusi.fragmenta.title:Azanes
/exist/apps/fragtrag/achaeusi/fragmenta/Achaeusi_FRAGMENTA.xml#Achaeusi-frag-2	urn:cite2:fragtrag:achaeusi.fragmenta.frag:2
/exist/apps/fragtrag/achaeusi/fragmenta/Achaeusi_FRAGMENTA.xml#Achaeusi-Athla-title	urn:cite2:fragtrag:achaeusi.fragmenta.title:Athla
/exist/apps/fragtrag/achaeusi/fragmenta/Achaeusi_FRAGMENTA.xml#Achaeusi-frag-3	urn:cite2:fragtrag:achaeusi.fragmenta.frag:3
/exist/apps/fragtrag/achaeusi/fragmenta/Achaeusi_FRAGMENTA.xml#Achaeusi-frag-4	urn:cite2:fragtrag:achaeusi.fragmenta.frag:4
/exist/apps/fragtrag/achaeusi/fragmenta/Achaeusi_FRAGMENTA.xml#Achaeusi-frag-5	urn:cite2:fragtrag:achaeusi.fragmenta.frag:5
/exist/apps/fragtrag/achaeusi/fragmenta/Achaeusi_FRAGMENTA.xml#Achaeusi-Aithon-title	urn:cite2:fragtrag:achaeusi.fragmenta.title:Aithon
/exist/apps/fragtrag/achaeusi/fragmenta/Achaeusi_FRAGMENTA.xml#Achaeusi-rep-1	urn:cite2:fragtrag:achaeusi.fragmenta.rep:1
/exist/apps/fragtrag/achaeusi/fragmenta/Achaeusi_FRAGMENTA.xml#Achaeusi-frag-6	urn:cite2:fragtrag:achaeusi.fragmenta.frag:6
/exist/apps/fragtrag/achaeusi/fragmenta/Achaeusi_FRAGMENTA.xml#Achaeusi-frag-7	urn:cite2:fragtrag:achaeusi.fragmenta.frag:7
/exist/apps/fragtrag/achaeusi/fragmenta/Achaeusi_FRAGMENTA.xml#Achaeusi-frag-8	urn:cite2:fragtrag:achaeusi.fragmenta.frag:8
/exist/apps/fragtrag/achaeusi/fragmenta/Achaeusi_FRAGMENTA.xml#Achaeusi-frag-9	urn:cite2:fragtrag:achaeusi.fragmenta.frag:9
/exist/apps/fragtrag/achaeusi/fragmenta/Achaeusi_FRAGMENTA.xml#Achaeusi-frag-10	urn:cite2:fragtrag:achaeusi.fragmenta.frag:10
/exist/apps/fragtrag/achaeusi/fragmenta/Achaeusi_FRAGMENTA.xml#Achaeusi-frag-11	urn:cite2:fragtrag:achaeusi.fragmenta.frag:11
/exist/apps/fragtrag/achaeusi/fragmenta/Achaeusi_FRAGMENTA.xml#Achaeusi-Alkmeon-title	urn:cite2:fragtrag:achaeusi.fragmenta.title:Alkmeon
/exist/apps/fragtrag/achaeusi/fragmenta/Achaeusi_FRAGMENTA.xml#Achaeusi-frag-12	urn:cite2:fragtrag:achaeusi.fragmenta.frag:12
/exist/apps/fragtrag/achaeusi/fragmenta/Achaeusi_FRAGMENTA.xml#Achaeusi-frag-13	urn:cite2:fragtrag:achaeusi.fragmenta.frag:13
/exist/apps/fragtrag/achaeusi/fragmenta/Achaeusi_FRAGMENTA.xml#Achaeusi-frag-14	urn:cite2:fragtrag:achaeusi.fragmenta.frag:14
/exist/apps/fragtrag/achaeusi/fragmenta/Achaeusi_FRAGMENTA.xml#Achaeusi-frag-15	urn:cite2:fragtrag:achaeusi.fragmenta.frag:15
/exist/apps/fragtrag/achaeusi/fragmenta/Achaeusi_FRAGMENTA.xml#Achaeusi-Alphesiboia-title	urn:cite2:fragtrag:achaeusi.fragmenta.title:Alphesiboia
/exist/apps/fragtrag/achaeusi/fragmenta/Achaeusi_FRAGMENTA.xml#Achaeusi-frag-16	urn:cite2:fragtrag:achaeusi.fragmenta.frag:16
/exist/apps/fragtrag/achaeusi/fragmenta/Achaeusi_FRAGMENTA.xml#Achaeusi-rep-2	urn:cite2:fragtrag:achaeusi.fragmenta.rep:2
/exist/apps/fragtrag/achaeusi/fragmenta/Achaeusi_FRAGMENTA.xml#Achaeusi-Erginos-title	urn:cite2:fragtrag:achaeusi.fragmenta.title:Erginos
/exist/apps/fragtrag/achaeusi/fragmenta/Achaeusi_FRAGMENTA.xml#Achaeusi-Hephaistos-title	urn:cite2:fragtrag:achaeusi.fragmenta.title:Hephaistos
/exist/apps/fragtrag/achaeusi/fragmenta/Achaeusi_FRAGMENTA.xml#Achaeusi-rep-3	urn:cite2:fragtrag:achaeusi.fragmenta.rep:3
/exist/apps/fragtrag/achaeusi/fragmenta/Achaeusi_FRAGMENTA.xml#Achaeusi-frag-17	urn:cite2:fragtrag:achaeusi.fragmenta.frag:17
/exist/apps/fragtrag/achaeusi/fragmenta/Achaeusi_FRAGMENTA.xml#Achaeusi-Theseus-title	urn:cite2:fragtrag:achaeusi.fragmenta.title:Theseus
/exist/apps/fragtrag/achaeusi/fragmenta/Achaeusi_FRAGMENTA.xml#Achaeusi-frag-18	urn:cite2:fragtrag:achaeusi.fragmenta.frag:18
/exist/apps/fragtrag/achaeusi/fragmenta/Achaeusi_FRAGMENTA.xml#Achaeusi-frag-19	urn:cite2:fragtrag:achaeusi.fragmenta.frag:19
/exist/apps/fragtrag/achaeusi/fragmenta/Achaeusi_FRAGMENTA.xml#Achaeusi-Iris-title	urn:cite2:fragtrag:achaeusi.fragmenta.title:Iris
/exist/apps/fragtrag/achaeusi/fragmenta/Achaeusi_FRAGMENTA.xml#Achaeusi-frag-20	urn:cite2:fragtrag:achaeusi.fragmenta.frag:20
/exist/apps/fragtrag/achaeusi/fragmenta/Achaeusi_FRAGMENTA.xml#Achaeusi-rep-4	urn:cite2:fragtrag:achaeusi.fragmenta.rep:4
/exist/apps/fragtrag/achaeusi/fragmenta/Achaeusi_FRAGMENTA.xml#Achaeusi-frag-21	urn:cite2:fragtrag:achaeusi.fragmenta.frag:21
/exist/apps/fragtrag/achaeusi/fragmenta/Achaeusi_FRAGMENTA.xml#Achaeusi-frag-22	urn:cite2:fragtrag:achaeusi.fragmenta.frag:22
/exist/apps/fragtrag/achaeusi/fragmenta/Achaeusi_FRAGMENTA.xml#Achaeusi-frag-23	urn:cite2:fragtrag:achaeusi.fragmenta.frag:23
/exist/apps/fragtrag/achaeusi/fragmenta/Achaeusi_FRAGMENTA.xml#Achaeusi-Katapeira-title	urn:cite2:fragtrag:achaeusi.fragmenta.title:Katapeira
/exist/apps/fragtrag/achaeusi/fragmenta/Achaeusi_FRAGMENTA.xml#Achaeusi-frag-24	urn:cite2:fragtrag:achaeusi.fragmenta.frag:24
/exist/apps/fragtrag/achaeusi/fragmenta/Achaeusi_FRAGMENTA.xml#Achaeusi-Kyknos-title	urn:cite2:fragtrag:achaeusi.fragmenta.title:Kyknos
/exist/apps/fragtrag/achaeusi/fragmenta/Achaeusi_FRAGMENTA.xml#Achaeusi-frag-25	urn:cite2:fragtrag:achaeusi.fragmenta.frag:25
/exist/apps/fragtrag/achaeusi/fragmenta/Achaeusi_FRAGMENTA.xml#Achaeusi-frag-26	urn:cite2:fragtrag:achaeusi.fragmenta.frag:26
/exist/apps/fragtrag/achaeusi/fragmenta/Achaeusi_FRAGMENTA.xml#Achaeusi-frag-27	urn:cite2:fragtrag:achaeusi.fragmenta.frag:27
/exist/apps/fragtrag/achaeusi/fragmenta/Achaeusi_FRAGMENTA.xml#Achaeusi-Linos-title	urn:cite2:fragtrag:achaeusi.fragmenta.title:Linos
/exist/apps/fragtrag/achaeusi/fragmenta/Achaeusi_FRAGMENTA.xml#Achaeusi-frag-28	urn:cite2:fragtrag:achaeusi.fragmenta.frag:28
/exist/apps/fragtrag/achaeusi/fragmenta/Achaeusi_FRAGMENTA.xml#Achaeusi-Moirai-title	urn:cite2:fragtrag:achaeusi.fragmenta.title:Moirai
/exist/apps/fragtrag/achaeusi/fragmenta/Achaeusi_FRAGMENTA.xml#Achaeusi-frag-29	urn:cite2:fragtrag:achaeusi.fragmenta.frag:29
/exist/apps/fragtrag/achaeusi/fragmenta/Achaeusi_FRAGMENTA.xml#Achaeusi-frag-30	urn:cite2:fragtrag:achaeusi.fragmenta.frag:30
/exist/apps/fragtrag/achaeusi/fragmenta/Achaeusi_FRAGMENTA.xml#Achaeusi-Momos-title	urn:cite2:fragtrag:achaeusi.fragmenta.title:Momos
/exist/apps/fragtrag/achaeusi/fragmenta/Achaeusi_FRAGMENTA.xml#Achaeusi-frag-31	urn:cite2:fragtrag:achaeusi.fragmenta.frag:31
/exist/apps/fragtrag/achaeusi/fragmenta/Achaeusi_FRAGMENTA.xml#Achaeusi-frag-31	urn:cite2:fragtrag:achaeusi.fragmenta.frag:31
/exist/apps/fragtrag/achaeusi/fragmenta/Achaeusi_FRAGMENTA.xml#Achaeusi-Oidipous-title	urn:cite2:fragtrag:achaeusi.fragmenta.title:Oidipous
/exist/apps/fragtrag/achaeusi/fragmenta/Achaeusi_FRAGMENTA.xml#Achaeusi-frag-32	urn:cite2:fragtrag:achaeusi.fragmenta.frag:32
/exist/apps/fragtrag/achaeusi/fragmenta/Achaeusi_FRAGMENTA.xml#Achaeusi-frag-33	urn:cite2:fragtrag:achaeusi.fragmenta.frag:33
/exist/apps/fragtrag/achaeusi/fragmenta/Achaeusi_FRAGMENTA.xml#Achaeusi-Omphale-title	urn:cite2:fragtrag:achaeusi.fragmenta.title:Omphale
/exist/apps/fragtrag/achaeusi/fragmenta/Achaeusi_FRAGMENTA.xml#Achaeusi-frag-34	urn:cite2:fragtrag:achaeusi.fragmenta.frag:34
/exist/apps/fragtrag/achaeusi/fragmenta/Achaeusi_FRAGMENTA.xml#Achaeusi-frag-35	urn:cite2:fragtrag:achaeusi.fragmenta.frag:35
/exist/apps/fragtrag/achaeusi/fragmenta/Achaeusi_FRAGMENTA.xml#Achaeusi-frag-36	urn:cite2:fragtrag:achaeusi.fragmenta.frag:36
/exist/apps/fragtrag/achaeusi/fragmenta/Achaeusi_FRAGMENTA.xml#Achaeusi-frag-37	urn:cite2:fragtrag:achaeusi.fragmenta.frag:37
/exist/apps/fragtrag/achaeusi/fragmenta/Achaeusi_FRAGMENTA.xml#Achaeusi-Peirithous-title	urn:cite2:fragtrag:achaeusi.fragmenta.title:Peirithous
/exist/apps/fragtrag/achaeusi/fragmenta/Achaeusi_FRAGMENTA.xml#Achaeusi-frag-38	urn:cite2:fragtrag:achaeusi.fragmenta.frag:38
/exist/apps/fragtrag/achaeusi/fragmenta/Achaeusi_FRAGMENTA.xml#Achaeusi-Philoktetes-title	urn:cite2:fragtrag:achaeusi.fragmenta.title:Philoktetes
/exist/apps/fragtrag/achaeusi/fragmenta/Achaeusi_FRAGMENTA.xml#Achaeusi-frag-39	urn:cite2:fragtrag:achaeusi.fragmenta.frag:39
/exist/apps/fragtrag/achaeusi/fragmenta/Achaeusi_FRAGMENTA.xml#Achaeusi-Phrixos-title	urn:cite2:fragtrag:achaeusi.fragmenta.title:Phrixos
/exist/apps/fragtrag/achaeusi/fragmenta/Achaeusi_FRAGMENTA.xml#Achaeusi-frag-40	urn:cite2:fragtrag:achaeusi.fragmenta.frag:40
/exist/apps/fragtrag/achaeusi/fragmenta/Achaeusi_FRAGMENTA.xml#Achaeusi-UP-title	urn:cite2:fragtrag:achaeusi.fragmenta.title:UP
/exist/apps/fragtrag/achaeusi/fragmenta/Achaeusi_FRAGMENTA.xml#Achaeusi-frag-41	urn:cite2:fragtrag:achaeusi.fragmenta.frag:41
/exist/apps/fragtrag/achaeusi/fragmenta/Achaeusi_FRAGMENTA.xml#Achaeusi-frag-42	urn:cite2:fragtrag:achaeusi.fragmenta.frag:42
/exist/apps/fragtrag/achaeusi/fragmenta/Achaeusi_FRAGMENTA.xml#Achaeusi-frag-43	urn:cite2:fragtrag:achaeusi.fragmenta.frag:43
/exist/apps/fragtrag/achaeusi/fragmenta/Achaeusi_FRAGMENTA.xml#Achaeusi-frag-44	urn:cite2:fragtrag:achaeusi.fragmenta.frag:44
/exist/apps/fragtrag/achaeusi/fragmenta/Achaeusi_FRAGMENTA.xml#Achaeusi-frag-45	urn:cite2:fragtrag:achaeusi.fragmenta.frag:45
/exist/apps/fragtrag/achaeusi/fragmenta/Achaeusi_FRAGMENTA.xml#Achaeusi-frag-46	urn:cite2:fragtrag:achaeusi.fragmenta.frag:46
/exist/apps/fragtrag/achaeusi/fragmenta/Achaeusi_FRAGMENTA.xml#Achaeusi-frag-47	urn:cite2:fragtrag:achaeusi.fragmenta.frag:47
/exist/apps/fragtrag/achaeusi/fragmenta/Achaeusi_FRAGMENTA.xml#Achaeusi-frag-48	urn:cite2:fragtrag:achaeusi.fragmenta.frag:48
/exist/apps/fragtrag/achaeusi/fragmenta/Achaeusi_FRAGMENTA.xml#Achaeusi-frag-49	urn:cite2:fragtrag:achaeusi.fragmenta.frag:49
/exist/apps/fragtrag/achaeusi/fragmenta/Achaeusi_FRAGMENTA.xml#Achaeusi-frag-50	urn:cite2:fragtrag:achaeusi.fragmenta.frag:50
/exist/apps/fragtrag/achaeusi/fragmenta/Achaeusi_FRAGMENTA.xml#Achaeusi-frag-51	urn:cite2:fragtrag:achaeusi.fragmenta.frag:51
/exist/apps/fragtrag/achaeusi/fragmenta/Achaeusi_FRAGMENTA.xml#Achaeusi-frag-52	urn:cite2:fragtrag:achaeusi.fragmenta.frag:52
/exist/apps/fragtrag/achaeusi/fragmenta/Achaeusi_FRAGMENTA.xml#Achaeusi-frag-53	urn:cite2:fragtrag:achaeusi.fragmenta.frag:53
/exist/apps/fragtrag/carcinusi/testimonia/Carcinusi_TESTIMONIA.xml#Carcinusi-test-1	urn:cite2:fragtrag:carcinusi.testimonia.test:1
/exist/apps/fragtrag/carcinusi/testimonia/Carcinusi_TESTIMONIA.xml#Carcinusi-test-2	urn:cite2:fragtrag:carcinusi.testimonia.test:2
/exist/apps/fragtrag/carcinusi/testimonia/Carcinusi_TESTIMONIA.xml#Carcinusi-test-3	urn:cite2:fragtrag:carcinusi.testimonia.test:3
/exist/apps/fragtrag/carcinusi/testimonia/Carcinusi_TESTIMONIA.xml#Carcinusi-test-4	urn:cite2:fragtrag:carcinusi.testimonia.test:4
/exist/apps/fragtrag/carcinusi/testimonia/Carcinusi_TESTIMONIA.xml#Carcinusi-test-5	urn:cite2:fragtrag:carcinusi.testimonia.test:5
/exist/apps/fragtrag/carcinusi/testimonia/Carcinusi_TESTIMONIA.xml#Carcinusi-test-6	urn:cite2:fragtrag:carcinusi.testimonia.test:6
/exist/apps/fragtrag/carcinusi/testimonia/Carcinusi_TESTIMONIA.xml#Carcinusi-test-7	urn:cite2:fragtrag:carcinusi.testimonia.test:7
/exist/apps/fragtrag/carcinusi/testimonia/Carcinusi_TESTIMONIA.xml#Carcinusi-test-8	urn:cite2:fragtrag:carcinusi.testimonia.test:8
/exist/apps/fragtrag/carcinusi/testimonia/Carcinusi_TESTIMONIA.xml#Carcinusi-test-9	urn:cite2:fragtrag:carcinusi.testimonia.test:9
/exist/apps/fragtrag/carcinusi/testimonia/Carcinusi_TESTIMONIA.xml#Carcinusi-test-10	urn:cite2:fragtrag:carcinusi.testimonia.test:10
/exist/apps/fragtrag/carcinusi/testimonia/Carcinusi_TESTIMONIA.xml#Carcinusi-test-11	urn:cite2:fragtrag:carcinusi.testimonia.test:11
/exist/apps/fragtrag/carcinusi/testimonia/Carcinusi_TESTIMONIA.xml#Carcinusi-test-12	urn:cite2:fragtrag:carcinusi.testimonia.test:12
/exist/apps/fragtrag/carcinusi/testimonia/Carcinusi_TESTIMONIA.xml#Carcinusi-test-13	urn:cite2:fragtrag:carcinusi.testimonia.test:13
/exist/apps/fragtrag/carcinusi/testimonia/Carcinusi_TESTIMONIA.xml#Carcinusi-test-14	urn:cite2:fragtrag:carcinusi.testimonia.test:14
/exist/apps/fragtrag/carcinusi/testimonia/Carcinusi_TESTIMONIA.xml#Carcinusi-test-15	urn:cite2:fragtrag:carcinusi.testimonia.test:15
/exist/apps/fragtrag/carcinusi/testimonia/Carcinusi_TESTIMONIA.xml#Carcinusi-test-16	urn:cite2:fragtrag:carcinusi.testimonia.test:16
/exist/apps/fragtrag/carcinusi/testimonia/Carcinusi_TESTIMONIA.xml#Carcinusi-test-17	urn:cite2:fragtrag:carcinusi.testimonia.test:17
/exist/apps/fragtrag/carcinusi/testimonia/Carcinusi_TESTIMONIA.xml#Carcinusi-test-18	urn:cite2:fragtrag:carcinusi.testimonia.test:18
/exist/apps/fragtrag/carcinusi/testimonia/Carcinusi_TESTIMONIA.xml#Carcinusi-test-19	urn:cite2:fragtrag:carcinusi.testimonia.test:19
/exist/apps/fragtrag/carcinusi/fragmenta/Carcinusi_FRAGMENTA.xml#Carcinusi-UP-title	urn:cite2:fragtrag:carcinusi.fragmenta.title:UP
/exist/apps/fragtrag/carcinusi/fragmenta/Carcinusi_FRAGMENTA.xml#Carcinusi-frag-1	urn:cite2:fragtrag:carcinusi.fragmenta.frag:1
/exist/apps/fragtrag/iophon/testimonia/Iophon_TESTIMONIA.xml#Iophon-test-1	urn:cite2:fragtrag:iophon.testimonia.test:1
/exist/apps/fragtrag/iophon/testimonia/Iophon_TESTIMONIA.xml#Iophon-test-2	urn:cite2:fragtrag:iophon.testimonia.test:2
/exist/apps/fragtrag/iophon/testimonia/Iophon_TESTIMONIA.xml#Iophon-test-3	urn:cite2:fragtrag:iophon.testimonia.test:3
/exist/apps/fragtrag/iophon/testimonia/Iophon_TESTIMONIA.xml#Iophon-test-4	urn:cite2:fragtrag:iophon.testimonia.test:4
/exist/apps/fragtrag/iophon/testimonia/Iophon_TESTIMONIA.xml#Iophon-test-5	urn:cite2:fragtrag:iophon.testimonia.test:5
/exist/apps/fragtrag/iophon/testimonia/Iophon_TESTIMONIA.xml#Iophon-test-6	urn:cite2:fragtrag:iophon.testimonia.test:6
/exist/apps/fragtrag/iophon/testimonia/Iophon_TESTIMONIA.xml#Iophon-test-7	urn:cite2:fragtrag:iophon.testimonia.test:7
/exist/apps/fragtrag/iophon/testimonia/Iophon_TESTIMONIA.xml#Iophon-test-8	urn:cite2:fragtrag:iophon.testimonia.test:8
/exist/apps/fragtrag/iophon/testimonia/Iophon_TESTIMONIA.xml#Iophon-test-9	urn:cite2:fragtrag:iophon.testimonia.test:9
/exist/apps/fragtrag/iophon/testimonia/Iophon_TESTIMONIA.xml#Iophon-test-10	urn:cite2:fragtrag:iophon.testimonia.test:10
/exist/apps/fragtrag/iophon/testimonia/Iophon_TESTIMONIA.xml#Iophon-test-11	urn:cite2:fragtrag:iophon.testimonia.test:11
/exist/apps/fragtrag/iophon/testimonia/Iophon_TESTIMONIA.xml#Iophon-test-12	urn:cite2:fragtrag:iophon.testimonia.test:12
/exist/apps/fragtrag/iophon/testimonia/Iophon_TESTIMONIA.xml#Iophon-test-13	urn:cite2:fragtrag:iophon.testimonia.test:13
/exist/apps/fragtrag/iophon/fragmenta/Iophon_FRAGMENTA.xml#Iophon-Aktaion-title	urn:cite2:fragtrag:iophon.fragmenta.title:Aktaion
/exist/apps/fragtrag/iophon/fragmenta/Iophon_FRAGMENTA.xml#Iophon-Aulodoi-title	urn:cite2:fragtrag:iophon.fragmenta.title:Aulodoi
/exist/apps/fragtrag/iophon/fragmenta/Iophon_FRAGMENTA.xml#Iophon-frag-1	urn:cite2:fragtrag:iophon.fragmenta.frag:1
/exist/apps/fragtrag/iophon/fragmenta/Iophon_FRAGMENTA.xml#Iophon-Achilleus-title	urn:cite2:fragtrag:iophon.fragmenta.title:Achilleus
/exist/apps/fragtrag/iophon/fragmenta/Iophon_FRAGMENTA.xml#Iophon-Bakchai-title	urn:cite2:fragtrag:iophon.fragmenta.title:Bakchai
/exist/apps/fragtrag/iophon/fragmenta/Iophon_FRAGMENTA.xml#Iophon-frag-2	urn:cite2:fragtrag:iophon.fragmenta.frag:2
/exist/apps/fragtrag/iophon/fragmenta/Iophon_FRAGMENTA.xml#Iophon-Dexamenos-title	urn:cite2:fragtrag:iophon.fragmenta.title:Dexamenos
/exist/apps/fragtrag/iophon/fragmenta/Iophon_FRAGMENTA.xml#Iophon-Iliou-title	urn:cite2:fragtrag:iophon.fragmenta.title:Iliou
/exist/apps/fragtrag/iophon/fragmenta/Iophon_FRAGMENTA.xml#Iophon-Telephos-title	urn:cite2:fragtrag:iophon.fragmenta.title:Telephos
/exist/apps/fragtrag/iophon/fragmenta/Iophon_FRAGMENTA.xml#Iophon-UP-title	urn:cite2:fragtrag:iophon.fragmenta.title:UP
/exist/apps/fragtrag/iophon/fragmenta/Iophon_FRAGMENTA.xml#Iophon-rep-1	urn:cite2:fragtrag:iophon.fragmenta.rep:1
/exist/apps/fragtrag/melanthiusi/testimonia/Melanthiusi_TESTIMONIA.xml#Melanthiusi-test-1	urn:cite2:fragtrag:melanthiusi.testimonia.test:1
/exist/apps/fragtrag/melanthiusi/testimonia/Melanthiusi_TESTIMONIA.xml#Melanthiusi-test-2	urn:cite2:fragtrag:melanthiusi.testimonia.test:2
/exist/apps/fragtrag/melanthiusi/testimonia/Melanthiusi_TESTIMONIA.xml#Melanthiusi-test-3	urn:cite2:fragtrag:melanthiusi.testimonia.test:3
/exist/apps/fragtrag/melanthiusi/testimonia/Melanthiusi_TESTIMONIA.xml#Melanthiusi-test-4	urn:cite2:fragtrag:melanthiusi.testimonia.test:4
/exist/apps/fragtrag/melanthiusi/testimonia/Melanthiusi_TESTIMONIA.xml#Melanthiusi-test-5	urn:cite2:fragtrag:melanthiusi.testimonia.test:5
/exist/apps/fragtrag/melanthiusi/testimonia/Melanthiusi_TESTIMONIA.xml#Melanthiusi-test-6	urn:cite2:fragtrag:melanthiusi.testimonia.test:6
/exist/apps/fragtrag/melanthiusi/testimonia/Melanthiusi_TESTIMONIA.xml#Melanthiusi-test-7	urn:cite2:fragtrag:melanthiusi.testimonia.test:7
/exist/apps/fragtrag/melanthiusi/testimonia/Melanthiusi_TESTIMONIA.xml#Melanthiusi-test-8	urn:cite2:fragtrag:melanthiusi.testimonia.test:8
/exist/apps/fragtrag/melanthiusi/testimonia/Melanthiusi_TESTIMONIA.xml#Melanthiusi-test-9	urn:cite2:fragtrag:melanthiusi.testimonia.test:9
/exist/apps/fragtrag/melanthiusi/testimonia/Melanthiusi_TESTIMONIA.xml#Melanthiusi-test-10	urn:cite2:fragtrag:melanthiusi.testimonia.test:10
/exist/apps/fragtrag/melanthiusi/testimonia/Melanthiusi_TESTIMONIA.xml#Melanthiusi-test-11	urn:cite2:fragtrag:melanthiusi.testimonia.test:11
/exist/apps/fragtrag/melanthiusi/testimonia/Melanthiusi_TESTIMONIA.xml#Melanthiusi-test-12	urn:cite2:fragtrag:melanthiusi.testimonia.test:12
/exist/apps/fragtrag/melanthiusi/testimonia/Melanthiusi_TESTIMONIA.xml#Melanthiusi-test-13	urn:cite2:fragtrag:melanthiusi.testimonia.test:13
/exist/apps/fragtrag/melanthiusi/testimonia/Melanthiusi_TESTIMONIA.xml#Melanthiusi-test-14	urn:cite2:fragtrag:melanthiusi.testimonia.test:14
/exist/apps/fragtrag/melanthiusi/testimonia/Melanthiusi_TESTIMONIA.xml#Melanthiusi-test-15	urn:cite2:fragtrag:melanthiusi.testimonia.test:15
/exist/apps/fragtrag/melanthiusi/testimonia/Melanthiusi_TESTIMONIA.xml#Melanthiusi-test-16	urn:cite2:fragtrag:melanthiusi.testimonia.test:16
/exist/apps/fragtrag/melanthiusi/fragmenta/Melanthiusi_FRAGMENTA.xml#Melanthiusi-Medeia-title	urn:cite2:fragtrag:melanthiusi.fragmenta.title:Medeia
/exist/apps/fragtrag/melanthiusi/fragmenta/Melanthiusi_FRAGMENTA.xml#Melanthiusi-frag-1	urn:cite2:fragtrag:melanthiusi.fragmenta.frag:1
/exist/apps/fragtrag/philoclesi/testimonia/Philoclesi_TESTIMONIA.xml#Philoclesi-test-1	urn:cite2:fragtrag:philoclesi.testimonia.test:1
/exist/apps/fragtrag/philoclesi/testimonia/Philoclesi_TESTIMONIA.xml#Philoclesi-test-2	urn:cite2:fragtrag:philoclesi.testimonia.test:2
/exist/apps/fragtrag/philoclesi/testimonia/Philoclesi_TESTIMONIA.xml#Philoclesi-test-3	urn:cite2:fragtrag:philoclesi.testimonia.test:3
/exist/apps/fragtrag/philoclesi/testimonia/Philoclesi_TESTIMONIA.xml#Philoclesi-test-4	urn:cite2:fragtrag:philoclesi.testimonia.test:4
/exist/apps/fragtrag/philoclesi/testimonia/Philoclesi_TESTIMONIA.xml#Philoclesi-test-5	urn:cite2:fragtrag:philoclesi.testimonia.test:5
/exist/apps/fragtrag/philoclesi/testimonia/Philoclesi_TESTIMONIA.xml#Philoclesi-test-6	urn:cite2:fragtrag:philoclesi.testimonia.test:6
/exist/apps/fragtrag/philoclesi/testimonia/Philoclesi_TESTIMONIA.xml#Philoclesi-test-7	urn:cite2:fragtrag:philoclesi.testimonia.test:7
/exist/apps/fragtrag/philoclesi/testimonia/Philoclesi_TESTIMONIA.xml#Philoclesi-test-8	urn:cite2:fragtrag:philoclesi.testimonia.test:8
/exist/apps/fragtrag/philoclesi/testimonia/Philoclesi_TESTIMONIA.xml#Philoclesi-test-9	urn:cite2:fragtrag:philoclesi.testimonia.test:9
/exist/apps/fragtrag/philoclesi/testimonia/Philoclesi_TESTIMONIA.xml#Philoclesi-test-10	urn:cite2:fragtrag:philoclesi.testimonia.test:10
/exist/apps/fragtrag/philoclesi/testimonia/Philoclesi_TESTIMONIA.xml#Philoclesi-test-11	urn:cite2:fragtrag:philoclesi.testimonia.test:11
/exist/apps/fragtrag/philoclesi/testimonia/Philoclesi_TESTIMONIA.xml#Philoclesi-test-12	urn:cite2:fragtrag:philoclesi.testimonia.test:12
/exist/apps/fragtrag/philoclesi/testimonia/Philoclesi_TESTIMONIA.xml#Philoclesi-test-13	urn:cite2:fragtrag:philoclesi.testimonia.test:13
/exist/apps/fragtrag/philoclesi/testimonia/Philoclesi_TESTIMONIA.xml#Philoclesi-test-14	urn:cite2:fragtrag:philoclesi.testimonia.test:14
/exist/apps/fragtrag/philoclesi/testimonia/Philoclesi_TESTIMONIA.xml#Philoclesi-test-15	urn:cite2:fragtrag:philoclesi.testimonia.test:15
/exist/apps/fragtrag/philoclesi/testimonia/Philoclesi_TESTIMONIA.xml#Philoclesi-test-16	urn:cite2:fragtrag:philoclesi.testimonia.test:16
/exist/apps/fragtrag/philoclesi/testimonia/Philoclesi_TESTIMONIA.xml#Philoclesi-test-17	urn:cite2:fragtrag:philoclesi.testimonia.test:17
/exist/apps/fragtrag/philoclesi/fragmenta/Philoclesi_FRAGMENTA.xml#Philoclesi-Erigone-title	urn:cite2:fragtrag:philoclesi.fragmenta.title:Erigone
/exist/apps/fragtrag/philoclesi/fragmenta/Philoclesi_FRAGMENTA.xml#Philoclesi-Nauplios-title	urn:cite2:fragtrag:philoclesi.fragmenta.title:Nauplios
/exist/apps/fragtrag/philoclesi/fragmenta/Philoclesi_FRAGMENTA.xml#Philoclesi-Oidipous-title	urn:cite2:fragtrag:philoclesi.fragmenta.title:Oidipous
/exist/apps/fragtrag/philoclesi/fragmenta/Philoclesi_FRAGMENTA.xml#Philoclesi-Oineus-title	urn:cite2:fragtrag:philoclesi.fragmenta.title:Oineus
/exist/apps/fragtrag/philoclesi/fragmenta/Philoclesi_FRAGMENTA.xml#Philoclesi-Priamos-title	urn:cite2:fragtrag:philoclesi.fragmenta.title:Priamos
/exist/apps/fragtrag/philoclesi/fragmenta/Philoclesi_FRAGMENTA.xml#Philoclesi-Penelope-title	urn:cite2:fragtrag:philoclesi.fragmenta.title:Penelope
/exist/apps/fragtrag/philoclesi/fragmenta/Philoclesi_FRAGMENTA.xml#Philoclesi-Philoktetes-title	urn:cite2:fragtrag:philoclesi.fragmenta.title:Philoktetes
/exist/apps/fragtrag/philoclesi/fragmenta/Philoclesi_FRAGMENTA.xml#Philoclesi-Pandionis-title	urn:cite2:fragtrag:philoclesi.fragmenta.title:Pandionis
/exist/apps/fragtrag/philoclesi/fragmenta/Philoclesi_FRAGMENTA.xml#Philoclesi-Tereus-title	urn:cite2:fragtrag:philoclesi.fragmenta.title:Tereus
/exist/apps/fragtrag/philoclesi/fragmenta/Philoclesi_FRAGMENTA.xml#Philoclesi-frag-1	urn:cite2:fragtrag:philoclesi.fragmenta.frag:1
/exist/apps/fragtrag/philoclesi/fragmenta/Philoclesi_FRAGMENTA.xml#Philoclesi-UP-title	urn:cite2:fragtrag:philoclesi.fragmenta.title:UP
/exist/apps/fragtrag/philoclesi/fragmenta/Philoclesi_FRAGMENTA.xml#Philoclesi-rep-1	urn:cite2:fragtrag:philoclesi.fragmenta.rep:1
/exist/apps/fragtrag/philoclesi/fragmenta/Philoclesi_FRAGMENTA.xml#Philoclesi-rep-2	urn:cite2:fragtrag:philoclesi.fragmenta.rep:2
/exist/apps/fragtrag/philoclesi/fragmenta/Philoclesi_FRAGMENTA.xml#Philoclesi-frag-2	urn:cite2:fragtrag:philoclesi.fragmenta.frag:2
/exist/apps/fragtrag/acestor/testimonia/Acestor_TESTIMONIA.xml#Acestor-test-1	urn:cite2:fragtrag:acestor.testimonia.test:1
/exist/apps/fragtrag/acestor/testimonia/Acestor_TESTIMONIA.xml#Acestor-test-2	urn:cite2:fragtrag:acestor.testimonia.test:2
/exist/apps/fragtrag/acestor/testimonia/Acestor_TESTIMONIA.xml#Acestor-test-3	urn:cite2:fragtrag:acestor.testimonia.test:3
/exist/apps/fragtrag/acestor/testimonia/Acestor_TESTIMONIA.xml#Acestor-test-4	urn:cite2:fragtrag:acestor.testimonia.test:4
/exist/apps/fragtrag/acestor/testimonia/Acestor_TESTIMONIA.xml#Acestor-test-5	urn:cite2:fragtrag:acestor.testimonia.test:5
/exist/apps/fragtrag/acestor/testimonia/Acestor_TESTIMONIA.xml#Acestor-test-6	urn:cite2:fragtrag:acestor.testimonia.test:6
/exist/apps/fragtrag/acestor/testimonia/Acestor_TESTIMONIA.xml#Acestor-test-7	urn:cite2:fragtrag:acestor.testimonia.test:7
/exist/apps/fragtrag/acestor/testimonia/Acestor_TESTIMONIA.xml#Acestor-test-8	urn:cite2:fragtrag:acestor.testimonia.test:8
/exist/apps/fragtrag/nothippus/testimonia/Nothippus_TESTIMONIA.xml#Nothippus-test-1	urn:cite2:fragtrag:nothippus.testimonia.test:1
/exist/apps/fragtrag/nothippus/testimonia/Nothippus_TESTIMONIA.xml#Nothippus-test-2	urn:cite2:fragtrag:nothippus.testimonia.test:2
/exist/apps/fragtrag/gnesippus/testimonia/Gnesippus_TESTIMONIA.xml#Gnesippus-test-1	urn:cite2:fragtrag:gnesippus.testimonia.test:1
/exist/apps/fragtrag/gnesippus/testimonia/Gnesippus_TESTIMONIA.xml#Gnesippus-test-2	urn:cite2:fragtrag:gnesippus.testimonia.test:2
/exist/apps/fragtrag/gnesippus/testimonia/Gnesippus_TESTIMONIA.xml#Gnesippus-test-3	urn:cite2:fragtrag:gnesippus.testimonia.test:3
/exist/apps/fragtrag/gnesippus/testimonia/Gnesippus_TESTIMONIA.xml#Gnesippus-test-4	urn:cite2:fragtrag:gnesippus.testimonia.test:4
/exist/apps/fragtrag/gnesippus/testimonia/Gnesippus_TESTIMONIA.xml#Gnesippus-test-5	urn:cite2:fragtrag:gnesippus.testimonia.test:5
/exist/apps/fragtrag/gnesippus/testimonia/Gnesippus_TESTIMONIA.xml#Gnesippus-test-6	urn:cite2:fragtrag:gnesippus.testimonia.test:6
/exist/apps/fragtrag/theognis/testimonia/Theognis_TESTIMONIA.xml#Theognis-test-1	urn:cite2:fragtrag:theognis.testimonia.test:1
/exist/apps/fragtrag/theognis/testimonia/Theognis_TESTIMONIA.xml#Theognis-test-2	urn:cite2:fragtrag:theognis.testimonia.test:2
/exist/apps/fragtrag/theognis/testimonia/Theognis_TESTIMONIA.xml#Theognis-test-3	urn:cite2:fragtrag:theognis.testimonia.test:3
/exist/apps/fragtrag/theognis/testimonia/Theognis_TESTIMONIA.xml#Theognis-test-4	urn:cite2:fragtrag:theognis.testimonia.test:4
/exist/apps/fragtrag/theognis/testimonia/Theognis_TESTIMONIA.xml#Theognis-test-5	urn:cite2:fragtrag:theognis.testimonia.test:5
/exist/apps/fragtrag/theognis/testimonia/Theognis_TESTIMONIA.xml#Theognis-test-6	urn:cite2:fragtrag:theognis.testimonia.test:6
/exist/apps/fragtrag/theognis/fragmenta/Theognis_FRAGMENTA.xml#Theognis-UP-title	urn:cite2:fragtrag:theognis.fragmenta.title:UP
/exist/apps/fragtrag/theognis/fragmenta/Theognis_FRAGMENTA.xml#Theognis-frag-1	urn:cite2:fragtrag:theognis.fragmenta.frag:1
/exist/apps/fragtrag/theognis/fragmenta/Theognis_FRAGMENTA.xml#Theognis-rep-1	urn:cite2:fragtrag:theognis.fragmenta.rep:1
/exist/apps/fragtrag/morsimus/testimonia/Morsimus_TESTIMONIA.xml#Morsimus-test-1	urn:cite2:fragtrag:morsimus.testimonia.test:1
/exist/apps/fragtrag/morsimus/testimonia/Morsimus_TESTIMONIA.xml#Morsimus-test-2	urn:cite2:fragtrag:morsimus.testimonia.test:2
/exist/apps/fragtrag/morsimus/testimonia/Morsimus_TESTIMONIA.xml#Morsimus-test-3	urn:cite2:fragtrag:morsimus.testimonia.test:3
/exist/apps/fragtrag/morsimus/testimonia/Morsimus_TESTIMONIA.xml#Morsimus-test-4	urn:cite2:fragtrag:morsimus.testimonia.test:4
/exist/apps/fragtrag/morsimus/testimonia/Morsimus_TESTIMONIA.xml#Morsimus-test-5	urn:cite2:fragtrag:morsimus.testimonia.test:5
/exist/apps/fragtrag/morsimus/testimonia/Morsimus_TESTIMONIA.xml#Morsimus-test-6	urn:cite2:fragtrag:morsimus.testimonia.test:6
/exist/apps/fragtrag/morsimus/testimonia/Morsimus_TESTIMONIA.xml#Morsimus-test-7	urn:cite2:fragtrag:morsimus.testimonia.test:7
/exist/apps/fragtrag/morsimus/testimonia/Morsimus_TESTIMONIA.xml#Morsimus-test-8	urn:cite2:fragtrag:morsimus.testimonia.test:8
/exist/apps/fragtrag/morsimus/testimonia/Morsimus_TESTIMONIA.xml#Morsimus-test-9	urn:cite2:fragtrag:morsimus.testimonia.test:9
/exist/apps/fragtrag/morychus/testimonia/Morychus_TESTIMONIA.xml#Morychus-test-1	urn:cite2:fragtrag:morychus.testimonia.test:1
/exist/apps/fragtrag/morychus/testimonia/Morychus_TESTIMONIA.xml#Morychus-test-2	urn:cite2:fragtrag:morychus.testimonia.test:2
/exist/apps/fragtrag/morychus/testimonia/Morychus_TESTIMONIA.xml#Morychus-test-3	urn:cite2:fragtrag:morychus.testimonia.test:3
/exist/apps/fragtrag/morychus/testimonia/Morychus_TESTIMONIA.xml#Morychus-test-4	urn:cite2:fragtrag:morychus.testimonia.test:4
/exist/apps/fragtrag/morychus/testimonia/Morychus_TESTIMONIA.xml#Morychus-test-5	urn:cite2:fragtrag:morychus.testimonia.test:5
/exist/apps/fragtrag/morychus/testimonia/Morychus_TESTIMONIA.xml#Morychus-test-6	urn:cite2:fragtrag:morychus.testimonia.test:6
/exist/apps/fragtrag/morychus/testimonia/Morychus_TESTIMONIA.xml#Morychus-test-7	urn:cite2:fragtrag:morychus.testimonia.test:7
/exist/apps/fragtrag/morychus/testimonia/Morychus_TESTIMONIA.xml#Morychus-test-8	urn:cite2:fragtrag:morychus.testimonia.test:8
/exist/apps/fragtrag/morychus/testimonia/Morychus_TESTIMONIA.xml#Morychus-test-9	urn:cite2:fragtrag:morychus.testimonia.test:9
/exist/apps/fragtrag/morychus/testimonia/Morychus_TESTIMONIA.xml#Morychus-test-10	urn:cite2:fragtrag:morychus.testimonia.test:10
/exist/apps/fragtrag/morychus/testimonia/Morychus_TESTIMONIA.xml#Morychus-test-11	urn:cite2:fragtrag:morychus.testimonia.test:11
/exist/apps/fragtrag/morychus/testimonia/Morychus_TESTIMONIA.xml#Morychus-test-12	urn:cite2:fragtrag:morychus.testimonia.test:12
/exist/apps/fragtrag/morychus/testimonia/Morychus_TESTIMONIA.xml#Morychus-test-13	urn:cite2:fragtrag:morychus.testimonia.test:13
/exist/apps/fragtrag/hieronymus/testimonia/Hieronymus_TESTIMONIA.xml#Hieronymus-test-1	urn:cite2:fragtrag:hieronymus.testimonia.test:1
/exist/apps/fragtrag/hieronymus/testimonia/Hieronymus_TESTIMONIA.xml#Hieronymus-test-2	urn:cite2:fragtrag:hieronymus.testimonia.test:2
/exist/apps/fragtrag/hieronymus/testimonia/Hieronymus_TESTIMONIA.xml#Hieronymus-test-3	urn:cite2:fragtrag:hieronymus.testimonia.test:3
/exist/apps/fragtrag/hieronymus/testimonia/Hieronymus_TESTIMONIA.xml#Hieronymus-test-4	urn:cite2:fragtrag:hieronymus.testimonia.test:4
/exist/apps/fragtrag/sthenelus/testimonia/Sthenelus_TESTIMONIA.xml#Sthenelus-test-1	urn:cite2:fragtrag:sthenelus.testimonia.test:1
/exist/apps/fragtrag/sthenelus/testimonia/Sthenelus_TESTIMONIA.xml#Sthenelus-test-2	urn:cite2:fragtrag:sthenelus.testimonia.test:2
/exist/apps/fragtrag/sthenelus/testimonia/Sthenelus_TESTIMONIA.xml#Sthenelus-test-3	urn:cite2:fragtrag:sthenelus.testimonia.test:3
/exist/apps/fragtrag/sthenelus/testimonia/Sthenelus_TESTIMONIA.xml#Sthenelus-test-4	urn:cite2:fragtrag:sthenelus.testimonia.test:4
/exist/apps/fragtrag/sthenelus/testimonia/Sthenelus_TESTIMONIA.xml#Sthenelus-test-5	urn:cite2:fragtrag:sthenelus.testimonia.test:5
/exist/apps/fragtrag/sthenelus/testimonia/Sthenelus_TESTIMONIA.xml#Sthenelus-test-6	urn:cite2:fragtrag:sthenelus.testimonia.test:6
/exist/apps/fragtrag/sthenelus/fragmenta/Sthenelus_FRAGMENTA.xml#Sthenelus-UP-title	urn:cite2:fragtrag:sthenelus.fragmenta.title:UP
/exist/apps/fragtrag/sthenelus/fragmenta/Sthenelus_FRAGMENTA.xml#Sthenelus-frag-1	urn:cite2:fragtrag:sthenelus.fragmenta.frag:1
/exist/apps/fragtrag/sthenelus/fragmenta/Sthenelus_FRAGMENTA.xml#Sthenelus-frag-2	urn:cite2:fragtrag:sthenelus.fragmenta.frag:2
/exist/apps/fragtrag/xenoclesi/testimonia/Xenoclesi_TESTIMONIA.xml#Xenoclesi-test-1	urn:cite2:fragtrag:xenoclesi.testimonia.test:1
/exist/apps/fragtrag/xenoclesi/testimonia/Xenoclesi_TESTIMONIA.xml#Xenoclesi-test-2	urn:cite2:fragtrag:xenoclesi.testimonia.test:2
/exist/apps/fragtrag/xenoclesi/testimonia/Xenoclesi_TESTIMONIA.xml#Xenoclesi-test-3	urn:cite2:fragtrag:xenoclesi.testimonia.test:3
/exist/apps/fragtrag/xenoclesi/testimonia/Xenoclesi_TESTIMONIA.xml#Xenoclesi-test-4	urn:cite2:fragtrag:xenoclesi.testimonia.test:4
/exist/apps/fragtrag/xenoclesi/testimonia/Xenoclesi_TESTIMONIA.xml#Xenoclesi-test-5	urn:cite2:fragtrag:xenoclesi.testimonia.test:5
/exist/apps/fragtrag/xenoclesi/testimonia/Xenoclesi_TESTIMONIA.xml#Xenoclesi-test-6	urn:cite2:fragtrag:xenoclesi.testimonia.test:6
/exist/apps/fragtrag/xenoclesi/testimonia/Xenoclesi_TESTIMONIA.xml#Xenoclesi-test-7	urn:cite2:fragtrag:xenoclesi.testimonia.test:7
/exist/apps/fragtrag/xenoclesi/testimonia/Xenoclesi_TESTIMONIA.xml#Xenoclesi-test-8	urn:cite2:fragtrag:xenoclesi.testimonia.test:8
/exist/apps/fragtrag/xenoclesi/testimonia/Xenoclesi_TESTIMONIA.xml#Xenoclesi-test-9	urn:cite2:fragtrag:xenoclesi.testimonia.test:9
/exist/apps/fragtrag/xenoclesi/testimonia/Xenoclesi_TESTIMONIA.xml#Xenoclesi-test-10	urn:cite2:fragtrag:xenoclesi.testimonia.test:10
/exist/apps/fragtrag/xenoclesi/testimonia/Xenoclesi_TESTIMONIA.xml#Xenoclesi-test-11	urn:cite2:fragtrag:xenoclesi.testimonia.test:11
/exist/apps/fragtrag/xenoclesi/testimonia/Xenoclesi_TESTIMONIA.xml#Xenoclesi-test-12	urn:cite2:fragtrag:xenoclesi.testimonia.test:12
/exist/apps/fragtrag/xenoclesi/testimonia/Xenoclesi_TESTIMONIA.xml#Xenoclesi-test-13	urn:cite2:fragtrag:xenoclesi.testimonia.test:13
/exist/apps/fragtrag/xenoclesi/fragmenta/Xenoclesi_FRAGMENTA.xml#Xenoclesi-Oidipous-title	urn:cite2:fragtrag:xenoclesi.fragmenta.title:Oidipous
/exist/apps/fragtrag/xenoclesi/fragmenta/Xenoclesi_FRAGMENTA.xml#Xenoclesi-Lykaon-title	urn:cite2:fragtrag:xenoclesi.fragmenta.title:Lykaon
/exist/apps/fragtrag/xenoclesi/fragmenta/Xenoclesi_FRAGMENTA.xml#Xenoclesi-Bacchae-title	urn:cite2:fragtrag:xenoclesi.fragmenta.title:Bacchae
/exist/apps/fragtrag/xenoclesi/fragmenta/Xenoclesi_FRAGMENTA.xml#Xenoclesi-Athamas-title	urn:cite2:fragtrag:xenoclesi.fragmenta.title:Athamas
/exist/apps/fragtrag/xenoclesi/fragmenta/Xenoclesi_FRAGMENTA.xml#Xenoclesi-Likymnios-title	urn:cite2:fragtrag:xenoclesi.fragmenta.title:Likymnios
/exist/apps/fragtrag/xenoclesi/fragmenta/Xenoclesi_FRAGMENTA.xml#Xenoclesi-frag-1	urn:cite2:fragtrag:xenoclesi.fragmenta.frag:1
/exist/apps/fragtrag/datis/testimonia/Datis_TESTIMONIA.xml#Datis-test-1	urn:cite2:fragtrag:datis.testimonia.test:1
/exist/apps/fragtrag/datis/testimonia/Datis_TESTIMONIA.xml#Datis-test-2	urn:cite2:fragtrag:datis.testimonia.test:2
/exist/apps/fragtrag/datis/testimonia/Datis_TESTIMONIA.xml#Datis-test-3	urn:cite2:fragtrag:datis.testimonia.test:3
/exist/apps/fragtrag/datis/fragmenta/Datis_FRAGMENTA.xml#Datis-UP-title	urn:cite2:fragtrag:datis.fragmenta.title:UP
/exist/apps/fragtrag/datis/fragmenta/Datis_FRAGMENTA.xml#Datis-frag-1	urn:cite2:fragtrag:datis.fragmenta.frag:1
/exist/apps/fragtrag/menecrates/testimonia/Menecrates_TESTIMONIA.xml#Menecrates-test-1	urn:cite2:fragtrag:menecrates.testimonia.test:1
/exist/apps/fragtrag/menecrates/testimonia/Menecrates_TESTIMONIA.xml#Menecrates-test-2	urn:cite2:fragtrag:menecrates.testimonia.test:2
/exist/apps/fragtrag/menecrates/testimonia/Menecrates_TESTIMONIA.xml#Menecrates-test-3	urn:cite2:fragtrag:menecrates.testimonia.test:3
/exist/apps/fragtrag/nicomachusi/testimonia/Nicomachusi_TESTIMONIA.xml#Nicomachusi-test-1	urn:cite2:fragtrag:nicomachusi.testimonia.test:1
/exist/apps/fragtrag/nicomachusi/testimonia/Nicomachusi_TESTIMONIA.xml#Nicomachusi-test-2	urn:cite2:fragtrag:nicomachusi.testimonia.test:2
/exist/apps/fragtrag/nicomachusi/fragmenta/Nicomachusi_FRAGMENTA.xml#Nicomachusi-Oidipous-title	urn:cite2:fragtrag:nicomachusi.fragmenta.title:Oidipous
/exist/apps/fragtrag/nicomachusi/fragmenta/Nicomachusi_FRAGMENTA.xml#Nicomachusi-Amymone-title	urn:cite2:fragtrag:nicomachusi.fragmenta.title:Amymone
/exist/apps/fragtrag/nicomachusi/fragmenta/Nicomachusi_FRAGMENTA.xml#Nicomachusi-T-title	urn:cite2:fragtrag:nicomachusi.fragmenta.title:T
/exist/apps/fragtrag/heracleides/testimonia/Heracleides_TESTIMONIA.xml#Heracleides-test-1	urn:cite2:fragtrag:heracleides.testimonia.test:1
/exist/apps/fragtrag/heracleides/fragmenta/Heracleides_FRAGMENTA.xml#Heracleides-These...-title	urn:cite2:fragtrag:heracleides.fragmenta.title:These...
/exist/apps/fragtrag/callistratus/testimonia/Callistratus_TESTIMONIA.xml#Callistratus-test-1	urn:cite2:fragtrag:callistratus.testimonia.test:1
/exist/apps/fragtrag/callistratus/fragmenta/Callistratus_FRAGMENTA.xml#Callistratus-Amphilochos-title	urn:cite2:fragtrag:callistratus.fragmenta.title:Amphilochos
/exist/apps/fragtrag/callistratus/fragmenta/Callistratus_FRAGMENTA.xml#Callistratus-Ixion-title	urn:cite2:fragtrag:callistratus.fragmenta.title:Ixion
/exist/apps/fragtrag/agathon/testimonia/Agathon_TESTIMONIA.xml#Agathon-test-1	urn:cite2:fragtrag:agathon.testimonia.test:1
/exist/apps/fragtrag/agathon/testimonia/Agathon_TESTIMONIA.xml#Agathon-test-2	urn:cite2:fragtrag:agathon.testimonia.test:2
/exist/apps/fragtrag/agathon/testimonia/Agathon_TESTIMONIA.xml#Agathon-test-3	urn:cite2:fragtrag:agathon.testimonia.test:3
/exist/apps/fragtrag/agathon/testimonia/Agathon_TESTIMONIA.xml#Agathon-test-4	urn:cite2:fragtrag:agathon.testimonia.test:4
/exist/apps/fragtrag/agathon/testimonia/Agathon_TESTIMONIA.xml#Agathon-test-5	urn:cite2:fragtrag:agathon.testimonia.test:5
/exist/apps/fragtrag/agathon/testimonia/Agathon_TESTIMONIA.xml#Agathon-test-6	urn:cite2:fragtrag:agathon.testimonia.test:6
/exist/apps/fragtrag/agathon/testimonia/Agathon_TESTIMONIA.xml#Agathon-test-7	urn:cite2:fragtrag:agathon.testimonia.test:7
/exist/apps/fragtrag/agathon/testimonia/Agathon_TESTIMONIA.xml#Agathon-test-8	urn:cite2:fragtrag:agathon.testimonia.test:8
/exist/apps/fragtrag/agathon/testimonia/Agathon_TESTIMONIA.xml#Agathon-test-9	urn:cite2:fragtrag:agathon.testimonia.test:9
/exist/apps/fragtrag/agathon/testimonia/Agathon_TESTIMONIA.xml#Agathon-test-10	urn:cite2:fragtrag:agathon.testimonia.test:10
/exist/apps/fragtrag/agathon/testimonia/Agathon_TESTIMONIA.xml#Agathon-test-11	urn:cite2:fragtrag:agathon.testimonia.test:11
/exist/apps/fragtrag/agathon/testimonia/Agathon_TESTIMONIA.xml#Agathon-test-12	urn:cite2:fragtrag:agathon.testimonia.test:12
/exist/apps/fragtrag/agathon/testimonia/Agathon_TESTIMONIA.xml#Agathon-test-13	urn:cite2:fragtrag:agathon.testimonia.test:13
/exist/apps/fragtrag/agathon/testimonia/Agathon_TESTIMONIA.xml#Agathon-test-14	urn:cite2:fragtrag:agathon.testimonia.test:14
/exist/apps/fragtrag/agathon/testimonia/Agathon_TESTIMONIA.xml#Agathon-test-15	urn:cite2:fragtrag:agathon.testimonia.test:15
/exist/apps/fragtrag/agathon/testimonia/Agathon_TESTIMONIA.xml#Agathon-test-16	urn:cite2:fragtrag:agathon.testimonia.test:16
/exist/apps/fragtrag/agathon/testimonia/Agathon_TESTIMONIA.xml#Agathon-test-17	urn:cite2:fragtrag:agathon.testimonia.test:17
/exist/apps/fragtrag/agathon/testimonia/Agathon_TESTIMONIA.xml#Agathon-test-18	urn:cite2:fragtrag:agathon.testimonia.test:18
/exist/apps/fragtrag/agathon/testimonia/Agathon_TESTIMONIA.xml#Agathon-test-19	urn:cite2:fragtrag:agathon.testimonia.test:19
/exist/apps/fragtrag/agathon/testimonia/Agathon_TESTIMONIA.xml#Agathon-test-20	urn:cite2:fragtrag:agathon.testimonia.test:20
/exist/apps/fragtrag/agathon/testimonia/Agathon_TESTIMONIA.xml#Agathon-test-21	urn:cite2:fragtrag:agathon.testimonia.test:21
/exist/apps/fragtrag/agathon/testimonia/Agathon_TESTIMONIA.xml#Agathon-test-22	urn:cite2:fragtrag:agathon.testimonia.test:22
/exist/apps/fragtrag/agathon/testimonia/Agathon_TESTIMONIA.xml#Agathon-test-23	urn:cite2:fragtrag:agathon.testimonia.test:23
/exist/apps/fragtrag/agathon/testimonia/Agathon_TESTIMONIA.xml#Agathon-test-24	urn:cite2:fragtrag:agathon.testimonia.test:24
/exist/apps/fragtrag/agathon/testimonia/Agathon_TESTIMONIA.xml#Agathon-test-25	urn:cite2:fragtrag:agathon.testimonia.test:25
/exist/apps/fragtrag/agathon/testimonia/Agathon_TESTIMONIA.xml#Agathon-test-26	urn:cite2:fragtrag:agathon.testimonia.test:26
/exist/apps/fragtrag/agathon/testimonia/Agathon_TESTIMONIA.xml#Agathon-test-27	urn:cite2:fragtrag:agathon.testimonia.test:27
/exist/apps/fragtrag/agathon/testimonia/Agathon_TESTIMONIA.xml#Agathon-test-28	urn:cite2:fragtrag:agathon.testimonia.test:28
/exist/apps/fragtrag/agathon/testimonia/Agathon_TESTIMONIA.xml#Agathon-test-29	urn:cite2:fragtrag:agathon.testimonia.test:29
/exist/apps/fragtrag/agathon/fragmenta/Agathon_FRAGMENTA.xml#Agathon-Aerope-title	urn:cite2:fragtrag:agathon.fragmenta.title:Aerope
/exist/apps/fragtrag/agathon/fragmenta/Agathon_FRAGMENTA.xml#Agathon-frag-1	urn:cite2:fragtrag:agathon.fragmenta.frag:1
/exist/apps/fragtrag/agathon/fragmenta/Agathon_FRAGMENTA.xml#Agathon-Alkmeon-title	urn:cite2:fragtrag:agathon.fragmenta.title:Alkmeon
/exist/apps/fragtrag/agathon/fragmenta/Agathon_FRAGMENTA.xml#Agathon-frag-2	urn:cite2:fragtrag:agathon.fragmenta.frag:2
/exist/apps/fragtrag/agathon/fragmenta/Agathon_FRAGMENTA.xml#Agathon-Anthos-title	urn:cite2:fragtrag:agathon.fragmenta.title:Anthos
/exist/apps/fragtrag/agathon/fragmenta/Agathon_FRAGMENTA.xml#Agathon-rep-1	urn:cite2:fragtrag:agathon.fragmenta.rep:1
/exist/apps/fragtrag/agathon/fragmenta/Agathon_FRAGMENTA.xml#Agathon-Thyestes-title	urn:cite2:fragtrag:agathon.fragmenta.title:Thyestes
/exist/apps/fragtrag/agathon/fragmenta/Agathon_FRAGMENTA.xml#Agathon-rep-2	urn:cite2:fragtrag:agathon.fragmenta.rep:2
/exist/apps/fragtrag/agathon/fragmenta/Agathon_FRAGMENTA.xml#Agathon-frag-3	urn:cite2:fragtrag:agathon.fragmenta.frag:3
/exist/apps/fragtrag/agathon/fragmenta/Agathon_FRAGMENTA.xml#Agathon-Mysoi-title	urn:cite2:fragtrag:agathon.fragmenta.title:Mysoi
/exist/apps/fragtrag/agathon/fragmenta/Agathon_FRAGMENTA.xml#Agathon-rep-3	urn:cite2:fragtrag:agathon.fragmenta.rep:3
/exist/apps/fragtrag/agathon/fragmenta/Agathon_FRAGMENTA.xml#Agathon-Telephos-title	urn:cite2:fragtrag:agathon.fragmenta.title:Telephos
/exist/apps/fragtrag/agathon/fragmenta/Agathon_FRAGMENTA.xml#Agathon-frag-4	urn:cite2:fragtrag:agathon.fragmenta.frag:4
/exist/apps/fragtrag/agathon/fragmenta/Agathon_FRAGMENTA.xml#Agathon-UP-title	urn:cite2:fragtrag:agathon.fragmenta.title:UP
/exist/apps/fragtrag/agathon/fragmenta/Agathon_FRAGMENTA.xml#Agathon-frag-5	urn:cite2:fragtrag:agathon.fragmenta.frag:5
/exist/apps/fragtrag/agathon/fragmenta/Agathon_FRAGMENTA.xml#Agathon-frag-6	urn:cite2:fragtrag:agathon.fragmenta.frag:6
/exist/apps/fragtrag/agathon/fragmenta/Agathon_FRAGMENTA.xml#Agathon-frag-7	urn:cite2:fragtrag:agathon.fragmenta.frag:7
/exist/apps/fragtrag/agathon/fragmenta/Agathon_FRAGMENTA.xml#Agathon-frag-8	urn:cite2:fragtrag:agathon.fragmenta.frag:8
/exist/apps/fragtrag/agathon/fragmenta/Agathon_FRAGMENTA.xml#Agathon-frag-9	urn:cite2:fragtrag:agathon.fragmenta.frag:9
/exist/apps/fragtrag/agathon/fragmenta/Agathon_FRAGMENTA.xml#Agathon-rep-4	urn:cite2:fragtrag:agathon.fragmenta.rep:4
/exist/apps/fragtrag/agathon/fragmenta/Agathon_FRAGMENTA.xml#Agathon-frag-10	urn:cite2:fragtrag:agathon.fragmenta.frag:10
/exist/apps/fragtrag/agathon/fragmenta/Agathon_FRAGMENTA.xml#Agathon-frag-11	urn:cite2:fragtrag:agathon.fragmenta.frag:11
/exist/apps/fragtrag/agathon/fragmenta/Agathon_FRAGMENTA.xml#Agathon-frag-12	urn:cite2:fragtrag:agathon.fragmenta.frag:12
/exist/apps/fragtrag/agathon/fragmenta/Agathon_FRAGMENTA.xml#Agathon-frag-13	urn:cite2:fragtrag:agathon.fragmenta.frag:13
/exist/apps/fragtrag/agathon/fragmenta/Agathon_FRAGMENTA.xml#Agathon-frag-14	urn:cite2:fragtrag:agathon.fragmenta.frag:14
/exist/apps/fragtrag/agathon/fragmenta/Agathon_FRAGMENTA.xml#Agathon-frag-15	urn:cite2:fragtrag:agathon.fragmenta.frag:15
/exist/apps/fragtrag/agathon/fragmenta/Agathon_FRAGMENTA.xml#Agathon-rep-5	urn:cite2:fragtrag:agathon.fragmenta.rep:5
/exist/apps/fragtrag/agathon/fragmenta/Agathon_FRAGMENTA.xml#Agathon-frag-16	urn:cite2:fragtrag:agathon.fragmenta.frag:16
/exist/apps/fragtrag/agathon/fragmenta/Agathon_FRAGMENTA.xml#Agathon-frag-17	urn:cite2:fragtrag:agathon.fragmenta.frag:17
/exist/apps/fragtrag/agathon/fragmenta/Agathon_FRAGMENTA.xml#Agathon-frag-18	urn:cite2:fragtrag:agathon.fragmenta.frag:18
/exist/apps/fragtrag/agathon/fragmenta/Agathon_FRAGMENTA.xml#Agathon-frag-19	urn:cite2:fragtrag:agathon.fragmenta.frag:19
/exist/apps/fragtrag/agathon/fragmenta/Agathon_FRAGMENTA.xml#Agathon-frag-20	urn:cite2:fragtrag:agathon.fragmenta.frag:20
/exist/apps/fragtrag/agathon/fragmenta/Agathon_FRAGMENTA.xml#Agathon-frag-21	urn:cite2:fragtrag:agathon.fragmenta.frag:21
/exist/apps/fragtrag/agathon/fragmenta/Agathon_FRAGMENTA.xml#Agathon-frag-22	urn:cite2:fragtrag:agathon.fragmenta.frag:22
/exist/apps/fragtrag/agathon/fragmenta/Agathon_FRAGMENTA.xml#Agathon-frag-23	urn:cite2:fragtrag:agathon.fragmenta.frag:23
/exist/apps/fragtrag/agathon/fragmenta/Agathon_FRAGMENTA.xml#Agathon-frag-24	urn:cite2:fragtrag:agathon.fragmenta.frag:24
/exist/apps/fragtrag/agathon/fragmenta/Agathon_FRAGMENTA.xml#Agathon-frag-25	urn:cite2:fragtrag:agathon.fragmenta.frag:25
/exist/apps/fragtrag/agathon/fragmenta/Agathon_FRAGMENTA.xml#Agathon-frag-26	urn:cite2:fragtrag:agathon.fragmenta.frag:26
/exist/apps/fragtrag/agathon/fragmenta/Agathon_FRAGMENTA.xml#Agathon-frag-27	urn:cite2:fragtrag:agathon.fragmenta.frag:27
/exist/apps/fragtrag/agathon/fragmenta/Agathon_FRAGMENTA.xml#Agathon-frag-28	urn:cite2:fragtrag:agathon.fragmenta.frag:28
/exist/apps/fragtrag/agathon/fragmenta/Agathon_FRAGMENTA.xml#Agathon-frag-29	urn:cite2:fragtrag:agathon.fragmenta.frag:29
/exist/apps/fragtrag/agathon/fragmenta/Agathon_FRAGMENTA.xml#Agathon-frag-30	urn:cite2:fragtrag:agathon.fragmenta.frag:30
/exist/apps/fragtrag/spintharus/testimonia/Spintharus_TESTIMONIA.xml#Spintharus-test-1	urn:cite2:fragtrag:spintharus.testimonia.test:1
/exist/apps/fragtrag/spintharus/testimonia/Spintharus_TESTIMONIA.xml#Spintharus-test-2	urn:cite2:fragtrag:spintharus.testimonia.test:2
/exist/apps/fragtrag/spintharus/testimonia/Spintharus_TESTIMONIA.xml#Spintharus-test-3	urn:cite2:fragtrag:spintharus.testimonia.test:3
/exist/apps/fragtrag/spintharus/testimonia/Spintharus_TESTIMONIA.xml#Spintharus-test-4	urn:cite2:fragtrag:spintharus.testimonia.test:4
/exist/apps/fragtrag/spintharus/testimonia/Spintharus_TESTIMONIA.xml#Spintharus-test-5	urn:cite2:fragtrag:spintharus.testimonia.test:5
/exist/apps/fragtrag/spintharus/fragmenta/Spintharus_FRAGMENTA.xml#Spintharus-Herakles-title	urn:cite2:fragtrag:spintharus.fragmenta.title:Herakles
/exist/apps/fragtrag/spintharus/fragmenta/Spintharus_FRAGMENTA.xml#Spintharus-Semele-title	urn:cite2:fragtrag:spintharus.fragmenta.title:Semele
/exist/apps/fragtrag/spintharus/fragmenta/Spintharus_FRAGMENTA.xml#Spintharus-Parthenopaios-title	urn:cite2:fragtrag:spintharus.fragmenta.title:Parthenopaios
/exist/apps/fragtrag/dorillus/testimonia/Dorillus_TESTIMONIA.xml#Dorillus-test-1	urn:cite2:fragtrag:dorillus.testimonia.test:1
/exist/apps/fragtrag/dorillus/testimonia/Dorillus_TESTIMONIA.xml#Dorillus-test-2	urn:cite2:fragtrag:dorillus.testimonia.test:2
/exist/apps/fragtrag/hippias/testimonia/Hippias_TESTIMONIA.xml#Hippias-test-1	urn:cite2:fragtrag:hippias.testimonia.test:1
/exist/apps/fragtrag/critias/testimonia/Critias_TESTIMONIA.xml#Critias-test-1	urn:cite2:fragtrag:critias.testimonia.test:1
/exist/apps/fragtrag/critias/testimonia/Critias_TESTIMONIA.xml#Critias-test-2	urn:cite2:fragtrag:critias.testimonia.test:2
/exist/apps/fragtrag/critias/testimonia/Critias_TESTIMONIA.xml#Critias-test-3	urn:cite2:fragtrag:critias.testimonia.test:3
/exist/apps/fragtrag/critias/testimonia/Critias_TESTIMONIA.xml#Critias-test-4	urn:cite2:fragtrag:critias.testimonia.test:4
/exist/apps/fragtrag/critias/fragmenta/Critias_FRAGMENTA.xml#Critias-Peirithous-title	urn:cite2:fragtrag:critias.fragmenta.title:Peirithous
/exist/apps/fragtrag/critias/fragmenta/Critias_FRAGMENTA.xml#Critias-rep-1	urn:cite2:fragtrag:critias.fragmenta.rep:1
/exist/apps/fragtrag/critias/fragmenta/Critias_FRAGMENTA.xml#Critias-frag-1	urn:cite2:fragtrag:critias.fragmenta.frag:1
/exist/apps/fragtrag/critias/fragmenta/Critias_FRAGMENTA.xml#Critias-frag-2	urn:cite2:fragtrag:critias.fragmenta.frag:2
/exist/apps/fragtrag/critias/fragmenta/Critias_FRAGMENTA.xml#Critias-frag-3	urn:cite2:fragtrag:critias.fragmenta.frag:3
/exist/apps/fragtrag/critias/fragmenta/Critias_FRAGMENTA.xml#Critias-frag-4	urn:cite2:fragtrag:critias.fragmenta.frag:4
/exist/apps/fragtrag/critias/fragmenta/Critias_FRAGMENTA.xml#Critias-frag-5	urn:cite2:fragtrag:critias.fragmenta.frag:5
/exist/apps/fragtrag/critias/fragmenta/Critias_FRAGMENTA.xml#Critias-frag-6	urn:cite2:fragtrag:critias.fragmenta.frag:6
/exist/apps/fragtrag/critias/fragmenta/Critias_FRAGMENTA.xml#Critias-frag-7	urn:cite2:fragtrag:critias.fragmenta.frag:7
/exist/apps/fragtrag/critias/fragmenta/Critias_FRAGMENTA.xml#Critias-frag-8	urn:cite2:fragtrag:critias.fragmenta.frag:8
/exist/apps/fragtrag/critias/fragmenta/Critias_FRAGMENTA.xml#Critias-frag-9	urn:cite2:fragtrag:critias.fragmenta.frag:9
/exist/apps/fragtrag/critias/fragmenta/Critias_FRAGMENTA.xml#Critias-frag-10	urn:cite2:fragtrag:critias.fragmenta.frag:10
/exist/apps/fragtrag/critias/fragmenta/Critias_FRAGMENTA.xml#Critias-frag-11	urn:cite2:fragtrag:critias.fragmenta.frag:11
/exist/apps/fragtrag/critias/fragmenta/Critias_FRAGMENTA.xml#Critias-frag-12	urn:cite2:fragtrag:critias.fragmenta.frag:12
/exist/apps/fragtrag/critias/fragmenta/Critias_FRAGMENTA.xml#Critias-frag-13	urn:cite2:fragtrag:critias.fragmenta.frag:13
/exist/apps/fragtrag/critias/fragmenta/Critias_FRAGMENTA.xml#Critias-frag-14	urn:cite2:fragtrag:critias.fragmenta.frag:14
/exist/apps/fragtrag/critias/fragmenta/Critias_FRAGMENTA.xml#Critias-frag-15	urn:cite2:fragtrag:critias.fragmenta.frag:15
/exist/apps/fragtrag/critias/fragmenta/Critias_FRAGMENTA.xml#Critias-Sisyphos-title	urn:cite2:fragtrag:critias.fragmenta.title:Sisyphos
/exist/apps/fragtrag/critias/fragmenta/Critias_FRAGMENTA.xml#Critias-frag-16	urn:cite2:fragtrag:critias.fragmenta.frag:16
/exist/apps/fragtrag/critias/fragmenta/Critias_FRAGMENTA.xml#Critias-UP-title	urn:cite2:fragtrag:critias.fragmenta.title:UP
/exist/apps/fragtrag/critias/fragmenta/Critias_FRAGMENTA.xml#Critias-frag-17	urn:cite2:fragtrag:critias.fragmenta.frag:17
/exist/apps/fragtrag/critias/fragmenta/Critias_FRAGMENTA.xml#Critias-frag-18	urn:cite2:fragtrag:critias.fragmenta.frag:18
/exist/apps/fragtrag/critias/fragmenta/Critias_FRAGMENTA.xml#Critias-frag-19	urn:cite2:fragtrag:critias.fragmenta.frag:19
/exist/apps/fragtrag/critias/fragmenta/Critias_FRAGMENTA.xml#Critias-frag-20	urn:cite2:fragtrag:critias.fragmenta.frag:20
/exist/apps/fragtrag/pythangelus/testimonia/Pythangelus_TESTIMONIA.xml#Pythangelus-test-1	urn:cite2:fragtrag:pythangelus.testimonia.test:1
/exist/apps/fragtrag/pythangelus/testimonia/Pythangelus_TESTIMONIA.xml#Pythangelus-test-2	urn:cite2:fragtrag:pythangelus.testimonia.test:2
/exist/apps/fragtrag/diogenes/testimonia/Diogenes_TESTIMONIA.xml#Diogenes-test-1	urn:cite2:fragtrag:diogenes.testimonia.test:1
/exist/apps/fragtrag/diogenes/testimonia/Diogenes_TESTIMONIA.xml#Diogenes-test-2	urn:cite2:fragtrag:diogenes.testimonia.test:2
/exist/apps/fragtrag/diogenes/testimonia/Diogenes_TESTIMONIA.xml#Diogenes-test-3	urn:cite2:fragtrag:diogenes.testimonia.test:3
/exist/apps/fragtrag/diogenes/fragmenta/Diogenes_FRAGMENTA.xml#Diogenes-Semele-title	urn:cite2:fragtrag:diogenes.fragmenta.title:Semele
/exist/apps/fragtrag/diogenes/fragmenta/Diogenes_FRAGMENTA.xml#Diogenes-frag-1	urn:cite2:fragtrag:diogenes.fragmenta.frag:1
/exist/apps/fragtrag/plato/testimonia/Plato_TESTIMONIA.xml#Plato-test-1	urn:cite2:fragtrag:plato.testimonia.test:1
/exist/apps/fragtrag/plato/testimonia/Plato_TESTIMONIA.xml#Plato-test-2	urn:cite2:fragtrag:plato.testimonia.test:2
/exist/apps/fragtrag/plato/testimonia/Plato_TESTIMONIA.xml#Plato-test-3	urn:cite2:fragtrag:plato.testimonia.test:3
/exist/apps/fragtrag/plato/testimonia/Plato_TESTIMONIA.xml#Plato-test-4	urn:cite2:fragtrag:plato.testimonia.test:4
/exist/apps/fragtrag/plato/testimonia/Plato_TESTIMONIA.xml#Plato-test-5	urn:cite2:fragtrag:plato.testimonia.test:5
/exist/apps/fragtrag/meletusi/testimonia/Meletusi_TESTIMONIA.xml#Meletusi-test-1	urn:cite2:fragtrag:meletusi.testimonia.test:1
/exist/apps/fragtrag/meletusi/testimonia/Meletusi_TESTIMONIA.xml#Meletusi-test-2	urn:cite2:fragtrag:meletusi.testimonia.test:2
/exist/apps/fragtrag/meletusi/testimonia/Meletusi_TESTIMONIA.xml#Meletusi-test-3	urn:cite2:fragtrag:meletusi.testimonia.test:3
/exist/apps/fragtrag/meletusi/testimonia/Meletusi_TESTIMONIA.xml#Meletusi-test-4	urn:cite2:fragtrag:meletusi.testimonia.test:4
/exist/apps/fragtrag/meletusi/testimonia/Meletusi_TESTIMONIA.xml#Meletusi-test-5	urn:cite2:fragtrag:meletusi.testimonia.test:5
/exist/apps/fragtrag/meletusi/testimonia/Meletusi_TESTIMONIA.xml#Meletusi-test-6	urn:cite2:fragtrag:meletusi.testimonia.test:6
/exist/apps/fragtrag/meletusi/testimonia/Meletusi_TESTIMONIA.xml#Meletusi-test-7	urn:cite2:fragtrag:meletusi.testimonia.test:7
/exist/apps/fragtrag/meletusii/testimonia/Meletusii_TESTIMONIA.xml#Meletusii-test-1	urn:cite2:fragtrag:meletusii.testimonia.test:1
/exist/apps/fragtrag/meletusii/testimonia/Meletusii_TESTIMONIA.xml#Meletusii-test-2	urn:cite2:fragtrag:meletusii.testimonia.test:2
/exist/apps/fragtrag/meletusii/testimonia/Meletusii_TESTIMONIA.xml#Meletusii-test-3	urn:cite2:fragtrag:meletusii.testimonia.test:3
/exist/apps/fragtrag/meletusii/testimonia/Meletusii_TESTIMONIA.xml#Meletusii-test-4	urn:cite2:fragtrag:meletusii.testimonia.test:4
/exist/apps/fragtrag/meletusii/testimonia/Meletusii_TESTIMONIA.xml#Meletusii-test-5	urn:cite2:fragtrag:meletusii.testimonia.test:5
/exist/apps/fragtrag/meletusii/testimonia/Meletusii_TESTIMONIA.xml#Meletusii-test-6	urn:cite2:fragtrag:meletusii.testimonia.test:6
/exist/apps/fragtrag/meletusii/testimonia/Meletusii_TESTIMONIA.xml#Meletusii-test-7	urn:cite2:fragtrag:meletusii.testimonia.test:7
/exist/apps/fragtrag/meletusii/fragmenta/Meletusii_FRAGMENTA.xml#Meletusii-Oidipodeia-title	urn:cite2:fragtrag:meletusii.fragmenta.title:Oidipodeia
/exist/apps/fragtrag/demetrius/testimonia/Demetrius_TESTIMONIA.xml#Demetrius-test-1	urn:cite2:fragtrag:demetrius.testimonia.test:1
/exist/apps/fragtrag/demetrius/fragmenta/Demetrius_FRAGMENTA.xml#Demetrius-USD-title	urn:cite2:fragtrag:demetrius.fragmenta.title:USD
